dema	để mà
amphan	âm phần
bacpho	bạc phơ
bongvang	bông vang
auhoa	âu hóa
bokinh	bố kinh
ancosooconoi	ăn có sở, ở có nơi
anphutay	An Phú Tây
an-ket	an-két
amen	amen
aolotlong	áo lọt lòng
biet	biệt
amban	âm bản
annhip	ăn nhịp
bacboi	bạc bội
binhkhuong	Bình Khương
binhlinh	bình linh
antay	ăn tay
bamtay	bấm tay
ba-zo	ba-zơ
bonben	bốn bên
banlietin	bản liệt in
bonglongbanglang	bông lông bang lang
acmonica	ác mô ni ca
banggau	băng gầu
bongquangam	bóng quang âm
ankhan	ăn khan
bongnuoc	bọng nước
baotang	báo tang
atpi-rin	át pi-rin
ac-coocde-ong	ắc-coóc đê-ông
balap	ba láp
bongguong	bóng gương
banthanbuonthanh	bán thần buôn thánh
anduc	ân Đức
bienco	biến cố
batcolaivang	bất cố lai vãng
andomoi	ăn dỗ mồi
anhong	An Hồng
adua	a dua
anhonnoikem	ăn hơn nói kém
banhtroinuoc	bánh trôi nước
batanbatde	bát ăn bát để
botay	bó tay
bienthai	biến thái
amcuoi	âm cuối
aogi-le	áo gi-lê
bachthuan	Bách Thuận
binhphuc	binh phục
bannien	bán niên
anchonnoichoichonban	ăn chọn nơi, chơi chọn bạn
ao	áo
bietdai	biệt đãi
bacai	Bác ái
acgiaacbao	ác giả ác báo
baybua	bảy búa
bale	ba lê
antruong	An Trường
boivoi	bôi vôi
baoluuykien	bảo lưu ý kiến
annomacam	ăn no mặc ấm
annhuhabadanhvuc	ăn như hà bá đánh vực
bonggiua	bông giua
bosayhoi	bộ sấy hơi
beboi	bể bơi
boconganh	bồ công anh
bava	ba vạ
bientap	biên tập
bonxoi	bón xới
adang	a đảng
bantang	ban tặng
baoloc	Bảo Lộc
baobinh	Bảo Bình
bodoidiaphuong	bộ đội địa phương
batoac	ba toác
anhuu	ân Hữu
binhthuy	bình thuỷ
bombo	Bom Bo
boihoi	bồi hồi
biabot	bia bọt
annoimotgiong	ăn nói một gióng
badausautay	ba đầu sáu tay
aiho	ái hộ
banhkem	bánh kem
bon-se-vich	bôn-sê-vích
battantaydaytancanh	bắt tận tay day tận cánh
bachuc	ba chục
baccuong	Bắc Cường
bamnhudiadoi	bám như đỉa đói
boison	Bồi Sơn
ayay	ay áy
antai	ăn tái
anbay	ăn bậy
batoong	batoong
apsuatthuyluc	áp suất thuỷ lực
ankhem	ăn khem
baoham	bao hàm
battien	bát tiền
anloi	ăn lời
baingoai	bài ngoại
baita	bái tạ
anmacdochodoque	ăn mặc dở chợ dở quê
bindinh	bin đinh
bangdinh	băng dính
bien	biên
ancuu	An Cựu
ban-me	ban-me
anhhungmatlo	anh hùng mạt lộ
binhtuong	Bình Tường
bekien	bệ kiến
bonggon	bông gòn
bosao	Bồ Sao
amque	ám quẻ
bannang	bản năng
banhuot	bánh ướt
bayla	bay la
anmotmamnammotchieu	ăn một mâm nằm một chiếu
bangnganvuotbien	băng ngàn vượt biển
bacbaccuaquyen	bắc bậc cửa quyền
anhue	ân huệ
binhdan	bình dân
bieng	biếng
bentamlangbennuacan	bên tám lạng bên nửa cân
bala	ba lá
atong	a tòng
bandaybanmong	bàn dày bàn mỏng
bien	biện
amcucduonghoi	âm cực dương hồi
anbotanxo	ăn bớt ăn xớ
anchancacomchim	ăn chặn cả cơm chim
bopmombopmieng	bóp mồm bóp miệng
aoxanh	áo xanh
angioanchap	ăn giỗ ăn chạp
baibai	bai bải
batdung	bất dung
andoiokiep	ăn đời ở kiếp
antuoi	ẩn tuổi
bancaunao	bán cầu não
bobui	bờ bụi
andaunamnho	ăn đậu nằm nhờ
beudieu	bêu diếu
baitran	bại trận
bangkhen	bằng khen
baoquoc	bảo quốc
ancaynuotdang	ăn cay nuốt đắng
bonthan	bổn thân
anban	ăn bẩn
actam	ác tâm
bogay	bọ gậy
amvi	âm vị
bacmau	bạc màu
banhthuan	bánh thuẫn
bachvien	bạch viên
bamvam	băm vằm
amty	âm ty
anloc	An Lộc
anhot	ăn hớt
ambathoi	âm bật hơi
banxeo	Bản Xèo
anquyet	ấn quyết
betre	bê trễ
banhducbaysang	bánh đúc bày sàng
auphuc	âu phục
baodo	bạo đồ
baisankhuynhgia	bại sản khuynh gia
baucu	bầu cử
anngon	ăn ngọn
aogoi	áo gối
aiphi	ái phi
benhtruyennhiem	bệnh truyền nhiễm
anphuthuan	An Phú Thuận
baona	bao nả
binhchuan	Bình Chuẩn
aocuoi	áo cưới
batphuong	bát phương
bacan	Bắc An
aolan	áo lặn
bongnuatoi	bóng nửa tối
batkhoanbatnhat	bắt khoan bắt nhặt
anhoilo	ăn hối lộ
bich-toong	bích-toong
batthanhvan	bất thành văn
aogammacngay	áo gấm mặc ngày
balangbaycho	ba làng bảy chợ
benno	bên nợ
binhminh	bình minh
binhchan	bình chân
antrang	An Tràng
binhyen	Bình Yên
battung	bật tung
bamuigiapcong	ba mũi giáp công
biendang	biến dạng
borau	bỏ rầu
autrivien	ấu trĩ viên
binhla	Bình La
baitap	bãi tập
beta	bêta
anhaidong	An Hải Đông
boi	bổi
bietsao	biết sao
anminhbac	An Minh Bắc
bieton	biết ơn
acmoclongtrongbung	ác mọc lông trong bụng
boquyt	bọ quýt
andeutieusong	ăn đều tiêu sòng
aibi	ai bi
bantang	bần tăng
a	a
bacte	bắc tê
bacnhannamhong	bắc nhạn nam hồng
boitron	bôi trơn
bienkhu	biên khu
baohangngay	báo hàng ngày
belimsaogay	bè lim sào gậy
ansang	ăn sáng
biennhan	biên nhận
bangtu	băng từ
boikieu	bói kiều
baicong	bãi công
anchangbodinhrang	ăn chẳng bõ dính răng
anhsangphancuc	ánh sáng phân cực
bannong	bần nông
bongo	bơ ngơ
a-dre-na-lin	a-đrê-na-lin
anquan	ấn quan
acbao	ác báo
amato	amatơ
ausau	âu sầu
a-xitlac-tic	a-xít lác-tíc
bangduoc	bằng được
anhduong	ảnh dương
bongnhien	bỗng nhiên
andonphac	An Đôn Phác
anhoc	ăn học
anuong	ăn uống
anlam	ăn làm
boiphat	bội phát
ainhi	ái nhi
biu	bíu
a-not	a-nốt
binhgia	Bình Gia
amusung	A Mú Sung
betoi	bề tôi
beonan	béo nân
bochuyendoi	bộ chuyển đổi
aovang	áo vàng
a-le	a-lê
bayhang	bày hàng
beoleo	bẻo lẻo
anbua	ăn bửa
andung	An Dũng
botre	bờ tre
boimoc	bơi móc
annoi	ăn nói
biahoi	bia hơi
bazooka	bazooka
ankhuat	ẩn khuất
banchai	bàn chải
bogao	bọ gạo
binhxa	Bình Xa
baotuong	báo tường
amaamu	ấm a ấm ứ
bactuoc	bác tước
aioan	ai oán
bothan	bó thân
baooan	báo oán
anninhdong	An Ninh Đông
angang	ăng ẳng
bolobala	bô lô ba la
ahoangmac	á hoang mạc
ahoan	a hoàn
beophe	béo phè
aiai	ải ải
bathangtrongcaymotngaytrongqua	ba tháng trông cây một ngày trông quả
banchaphanh	ban chấp hành
bamvien	băm viên
bontrodaitrau	bòn tro đãi trấu
bayhonbatvia	bay hồn bạt vía
banthanbattoai	bán thân bất toại
amdao	âm đạo
annon	ăn non
bababonchuyen	ba bà bốn chuyện
ansungmacsuong	ăn sung mặc sướng
battuy	bạt tụy
bonhingiudua	bồ nhìn giữ dưa
bogia	bố già
bangson	băng sơn
ahanhacnghiep	a hành ác nghiệp
anngaynoithang	ăn ngay nói thẳng
battuan	bát tuần
benhbinh	bệnh binh
bomnocham	bom nổ chậm
bietdongquan	biệt động quân
banhon	Bán Hon
anghe	ăn ghé
baoung	báo ứng
a	ă
baanbanoi	bạ ăn bạ nói
beonhucoixaycun	béo như cối xay cùn
banxoi	bán xới
anphong	An Phong
bongoong	Bờ Ngoong
aluoi	A Lưới
boduoc	bó đuốc
beo	beo
baixich	bài xích
bioi	bỉ ổi
baogan	bạo gan
benday	bên đây
anmattragung	ăn mật trả gừng
bache	ba chẽ
bietnhiem	biệt nhiễm
anlam	An Lâm
batquang	bắt quàng
bagian	bà giằn
angaoluoc	ăn gạo luộc
ac-quy	ắc-quy
bangchucai	bảng chữ cái
banchuidauchuimui	bận chúi đầu chúi mũi
baotu	bào tử
betrai	bề trái
am	âm
amto	âm tố
bacthay	bậc thầy
binhluanvien	bình luận viên
bietduongnao	biết dường nào
anhhungca	anh hùng ca
biettichchido	biệt tịch chi đồ
beo	bèo
biendau	biển đậu
bamgan	bấm gan
banchay	bán chạy
ansu	ân sư
ammuoi	ám muội
a-mi-noa-xit	a-mi-nô a-xít
bon-se-vich	bon-sê-vích
bangthua	bằng thừa
badinh	Ba Đình
banduong	bản dương
binhdong	Bình Đông
bohoi	bồ hôi
baolaunay	bao lâu nay
bangay	ba ngày
bot-tin	bốt-tin
botgiay	bột giấy
bathanh	Ba Thành
aomao	áo mão
bachmai	Bạch mai
annhat	ăn nhạt
aolotminh	áo lót mình
bangchuyen	băng chuyền
baoanbaonoi	bạo ăn bạo nói
baotu	báo tử
bo-lu	bờ-lu
avuong	A Vương
bochi	bõ chi
bomnguyentu	bom nguyên tử
bapchan	bắp chân
bocumedi	bố cu mẹ đĩ
bobin	bô bin
batbaodong	bất bạo động
bientocke	biến tốc kế
baoro	bào rờ
anchosuongmieng	ăn cho sướng miệng
annham	ăn nhằm
biencuong	biên cương
bou	bò u
bamrasua	bấm ra sữa
bacluong	bậc lương
beocam	bèo cám
bamcua	bam cửa
annhurongcuon	ăn như rồng cuốn
banhgai	bánh gai
beo	bẹo
benthuy	Bến Thuỷ
bontrinh	bôn trình
biendao	biên đạo
banrung	bàn rung
anboobui	ăn bờ ở bụi
bicam	bi cảm
a-raphoc	a-rập học
bedai	bề dài
biettongtongtong	biết tỏng tòng tong
bocthuoc	bốc thuốc
bakhia	ba khía
bandia	bản địa
bambao	bẩm báo
andiemtam	ăn điểm tâm
bactamcap	bậc tam cấp
aobo-lu-dong	áo bơ-lu-dông
anlaibua	ăn lại bữa
boichingansach	bội chi ngân sách
adidatamton	A Di Đà Tam Tôn
batnguon	bắt nguồn
aobao	áo bao
bi-dang-tin	bi-dăng-tin
anhkim	anh kim
banyennhan	Bần Yên Nhân
bientien	biển tiến
banhbao	bảnh bao
anofen	anofen
banchinhqui	bán chính qui
batchangduocthalamphuc	bắt chẳng được, tha làm phúc
banghahoc	băng hà học
ankhanh	ăn khảnh
binhcocong	bình cổ cong
bankhoan	băn khoăn
anhao	an hảo
bien	biến
bavuongbaytron	ba vuông bảy tròn
banhdalon	bánh da lợn
bolyhop	bộ ly hợp
bang	bang
baoholaodong	bảo hộ lao động
anmayhoanbigay	ăn mày hoàn bị gậy
aonao	áo não
bon	bon
anphuc	An Phúc
angio	ăn giỗ
bietdaumahamiengchoho	biết đâu mà há miệng chờ ho
aothogiayco	áo thô giày cỏ
binhhungtuonggioi	binh hùng tướng giỏi
bachqui	bạch quỉ
a-ti-so	a-ti-sô
a-vang	a-văng
beonheo	bèo nhèo
baocap	bao cấp
bontamdaihaitamngan	bốn tấm dài hai tấm ngắn
bam	băm
aophong	áo phông
bangia	Bản Già
baobi	bao bì
anmiengtramieng	ăn miếng trả miếng
aiuu	ái ưu
baybien	bày biện
bausen	Bàu Sen
banggiadinhvevang	bảng gia đình vẻ vang
baichi	bài chỉ
baobien	bao biện
autrang	Âu trang
benhoi	bện hơi
baibinhbotran	bài binh bố trận
bosung	bổ sung
bagioi	ba giỏi
bo-noong	Bơ-noong
banmatchodatbanlungchotroi	bán mặt cho đất, bán lưng cho trời
bapngo	bắp ngô
an-ti-pi-rin	an-ti-pi-rin
a-men	a-men
andomnoidat	ăn đơm nói đặt
baila	bài lá
balua	Bà Lụa
baynhieu	bây nhiêu
anman	ăn mặn
anchungocha	ăn chung ở chạ
bienvan	biền văn
be-ta	bê-ta
an-bu-min	an-bu-min
an-ti-mon	an-ti-mon
bapbong	bấp bông
benvuot	bến vượt
a-vang-ta	a-văng-ta
batphan	bất phân
bonuoi	bố nuôi
banghiep	bá nghiệp
binhphuoc	Bình Phước
banhtaiheo	bánh tai heo
anhao	ảnh ảo
boitu	bồi tụ
bangtang	băng tang
binhkieu	Bình Kiều
annovacnang	ăn no vác nặng
baibung	Bãi Bùng
ancau	ăn câu
adrenalin	adrenalin
antheothuootheothi	ăn theo thuở, ở theo thì
bachabayme	ba cha bảy mẹ
bom	bom
badoca	badôca
andoi	ăn dõi
boicheo	bói chèo
bang-ron	băng-rôn
binhtridong	Bình Trị Đông
baotan	bạo tàn
baubinh	bàu bĩnh
bonggao	bông gạo
an	ăn
bienho	Biển Hồ
amhuong	âm hưởng
anlinh	An Lĩnh
benguoitoconmat	bé người to con mắt
atieng	A Tiêng
banquyen	bản quyền
benkia	bên kia
ancannoibay	ăn càn nói bậy
binhan	Bình ân
aptoi	áp tới
binhquyen	bình quyền
aynay	áy náy
baoto	bão tố
banchapuy	ban chấp uỷ
atgiap	ất giáp
baotonbaotang	bảo tồn bảo tàng
anchang	ăn chằng
bandam	bán dâm
a-len	a-len
bichdao	Bích Đào
ansongnuottuoi	ăn sống nuốt tươì
antiem	ăn tiệm
bienbachdong	Biển Bạch Đông
banhgoi	bánh gối
apatit	a pa tít
annhan	ân nhân
bongthamkhong	bóng thám không
bidieu	bí diệu
bongtai	bông tai
bi-ki-ni	bi-ki-ni
bangiamdoc	ban giám đốc
bachandoi	bắc hàn đới
aunien	ấu niên
banhat	ba nhất
balamongiao	Bà La Môn giáo
bentiengquenhoi	bén tiếng quen hơi
bannguyenam	bán nguyên âm
benhvuc	bênh vực
antoanlaodong	an toàn lao động
bauleodaybicungleo	bầu leo, dây bí cũng leo
bonchungquanh	bốn chung quanh
antoan	An Toàn
boiban	bồi bàn
anonhubatnuocday	ăn ở như bát nước đầy
aco	ắc ô
aitinh	ái tình
banhca-vat	bánh ca-vát
bontau	bôn tẩu
anphutan	An Phú Tân
ancomthuacanhcan	ăn cơm thừa canh cặn
bo-ne	bo-nê
battien	bất tiện
baybinhbotran	bày binh bố trận
annenlamra	ăn nên làm ra
baolam	Bảo Lâm
banxiet	bàn xiết
andut	ăn đút
bannuocbuonnoi	bán nước buôn nòi
ancap	ăn cắp
banhrang	bánh răng
binhhoaphuoc	Bình Hoà Phước
anva	ăn vã
baotai	bao tải
andautrabo	ăn đấu trả bồ
biumoi	bĩu môi
battuy	bạt tuỵ
bietlaychican	biết lấy chi cân
batthuan	bất thuận
binhba	Bình Ba
baimon	bái môn
anbeoanxen	ăn bẻo ăn xén
alahan	a la hán
ba-ri-e	ba-ri-e
bachthuthanhgia	bạch thủ thành gia
baica	bài ca
bienly	biện lý
bathuoc	Bá Thước
batchuyen	bắt chuyện
bonchai	bòn chài
aoi	ạ ơi
aoquan	áo quan
au	Au
boinghich	bội nghịch
bienngam	biển ngắm
bamgansoimau	bầm gan sôi máu
aomay-o	áo may-ô
aoki-mo-no	áo ki-mô-nô
bandao	bần đạo
boi	bói
baohoa	bão hoà
batbao	bát bảo
am-pun	am-pun
baxa	Ba Xa
anguy	a nguỳ
anxuyt	ăn xuýt
binhhunghoa	Bình Hưng Hoà
anba	An Bá
bonglai	bồng lai
bolieu	bỏ liều
ankiengnamcu	ăn kiêng nằm cữ
batkhaquy	bất khả quy
adidakinh	A Di Đà kinh
a-xe-ti-len	a-xê-ti-len
aomua	áo mưa
anhem	anh em
bantaytrang	bàn tay trắng
bacphuong	bắc phương
banvan	bản văn
anmung	ăn mừng
betha	bê tha
battuong	bất tường
bacruot	bác ruột
batchimchim	bắt chim chim
baohoc	bảo học
banthao	bản thảo
bangrungvuotsuoi	băng rừng vượt suối
battiet	bát tiết
a-di-daphat	A-di-đà phật
bebet	be bét
bachcau	bạch câu
biengioi	Biên Giới
baogia	báo giá
bothanduong	bổ thận dương
batte	bạt tê
bosapbongua	bổ sấp bổ ngửa
aodaidairong	áo dài đai rộng
bancunghoa	bần cùng hóa
bolebocang	bò lê bò càng
ancochungchoicodo	ăn có chừng, chơi có độ
batcau	bất câu
bangnhao	báng nhạo
ancapnhuranh	ăn cắp như ranh
auhoa	Âu hoá
bangtam	băng tấm
batthanhnhan	bất thành nhân
aychet	ấy chết
a-tua-do-ron	a-tua-đờ-rôn
boica	bói cá
acnghiep	ác nghiệp
biensac	biến sắc
bacdai	bác đại
bothuongvuongtoi	bỏ thương vương tội
baitru	bài trừ
badao	ba đào
bantien	bần tiện
baolon	bao lơn
anbuahomlobuamai	ăn bữa hôm, lo bữa mai
bangnguyen	băng nguyên
bienbao	biển báo
bienthien	biến thiên
anguinamnho	ăn gửi nằm nhờ
bingo	bí ngô
anche	ăn ché
bachsinh	bách sinh
bichhoa	Bích Hoà
bachua	bà chúa
bachdaugiailao	bạch đầu giai lão
beolan	béo lăn
bithu	bi thu
a-me-ri-xi	a-me-ri-xi
antuc	ăn tục
ancoditruocloinuocdisau	ăn cổ đi trước, lội nước đi sau
binhdanhocvu	bình dân học vụ
ba-za	ba-za
angoi	ăn gỏi
baybay	bây bẩy
aothaytu	áo thầy tu
bododau	bố đỡ đầu
anhtutuc	anh tử túc
amkhi	âm khí
amlich	âm lịch
bangquan	bàng quan
angcanqua	áng can qua
bay	bẫy
bapcay	bắp cày
acmieng	ác miệng
bacbancau	bắc bán cầu
batdau	bắt đầu
bahonchinvia	ba hồn chín vía
batnuingansong	bạt núi ngăn sông
bode	bờ đê
baba	bà ba
beotruongbeonut	béo trương béo nứt
binhtrieu	Bình Triều
botxay	bột xay
barau	Bà Rậu
battoan	bất toàn
aodang	ảo đăng
bolai	bộ lại
bobonhuthangiucua	bo bo như thần giữ của
bienphaptutu	biện pháp tu từ
anthaitrung	An Thái Trung
banhdakhoai	bánh đa khoai
bichi	bi chí
bahoathientuong	ba hoa thiên tướng
banhque	bánh quế
ankhongngoiroi	ăn không ngồi rồi
baoninh	Bảo Ninh
baodung	bao dung
amsutvoi	ấm sứt vòi
bathoi	bật hơi
amboi	âm bội
bomthu	bom thư
apthapnhietdoi	áp thấp nhiệt đới
aoxiem	áo xiêm
binhtrungdong	Bình Trung Đông
baove	bảo vệ
baithuoc	bài thuốc
batchachdangduoi	bắt chạch đằng đuôi
baothai	bào thai
binhthe	bình the
bietsu	biệt sử
bobaichangbangphaithi	bơ bải chẳng bằng phải thì
binhlam	Bình Lâm
andutlot	ăn đút lót
angiai	ăn giải
bonnuoidong	bón nuôi đòng
bayla	bay là
baivong	bại vong
bakhan	Ba Khan
boc-can	bốc-can
bai	bãi
antao	ăn tảo
anlong	An Long
bansoan	bàn soạn
bongnhung	bỗng nhưng
bandoanh	bản doanh
binhthanh	bình thanh
boisochungnhonhat	bội số chung nhỏ nhất
base	base
bienuy	biên uỷ
axing	A Xing
bienche	biên chế
boxulitrungtam	bộ xử lí trung tâm
aokhongcadakhongmau	ao không cá, đá không màu
bekhactrieu	Bế Khắc Triệu
anto	ăn to
boxa	bỏ xa
botaybochan	bó tay bó chân
bangchianhbangem	bằng chị (anh) bằng em
boxoai	bổ xoài
baixuat	bài xuất
aoho	ao hồ
baruou	bã rượu
boikhoan	bồi khoản
binhphuong	bình phương
anthuong	An Thương
bietung	biệt ứng
ba-ren	ba-ren
baucot	bầu cột
benhbien	bệnh biến
biencanh	biên cảnh
authe	ấu thể
biendong	biến động
ba-long	ba-lông
bangquo	bâng quơ
baoban	bảo ban
aithuy	ái thuỷ
baothang	Bảo Thắng
bachlinh	bách linh
aobaotu	áo bào tử
aicatroncho	ai cắt rốn cho
antan	An Tân
aogio	áo gió
bangcau	băng cầu
bolebola	bò lê bò la
a-lehap	a-lê hấp
autho	ấu thơ
afghani	afghani
baotoan	bảo toàn
beotam	bèo tấm
amoai	ấm oái
bamuoisaucainonnuong	ba mươi sáu cái nõn nường
biphanvoivoi	bì phấn với vôi
ac-cooc-de-ong	ác-coóc-đê-ông
baixai	bái xái
bieudongtinh	biểu đồng tình
ba-do-ca	ba-dô-ca
betititi	bé tỉ tì ti
bacondoi	bắc ôn đới
antreo	án treo
a-la	A-la
bangnay	bằng nay
anlongolo	ăn lông ở lỗ
arooi	a Rooi
bieuxen	biếu xén
anquanhoketrongcay	ăn quả nhớ kẻ trồng cây
bato	Ba Tơ
ancomchuamuatoingay	ăn cơm chúa, múa tối ngày
bieuthi	biểu thị
bonglau	bông lau
bahoathiendia	ba hoa thiên địa
anphu	An Phú
bexerato	bé xé ra to
bin-dinh	bin-đinh
banmuong	bản mường
benrexanhcay	bén rễ xanh cây
aican	ái căn
bongsu	bông sứ
aoxanh	áo xanh ***
boichi	bội chi
banbay	bạn bầy
angiang	An Giang
aodon	áo đơn
anlien	ăn liền
aa	ă,Ă
aodoivai	áo đổi vai
bavong	Ba Vòng
baonang	bào nang
baoha	Bảo Hà
anmotannhat	ăn mót ăn nhặt
benco	bên có
beno-to	bến ô-tô
benhdai	bệnh dại
anmay	ăn mày
baychu	bấy chừ
baoduong	bảo dưỡng
baulam	Bàu Lâm
bongcauquacuaso	bóng câu qua cửa sổ
anthanh	An Thạnh
baobom	báo bờm
bennuoc	bến nước
ban-cong	ban-công
ankhanh	An Khánh
acidacetic	acid acetic
bichthuy	bích thủy
baychay	bây chầy
aocap	áo cặp
banthan	bán thân
anbam	ăn bẫm
batcongdaithien	bất cộng đái thiên
antrangmieng	ăn tráng miệng
bayhap	Bảy Háp
annghia	An Nghĩa
binhchung	binh chủng
baymau	bay màu
baimieng	bai miệng
anmuc	ăn mực
banggia	Bằng Giã
baitrung	bài trung
anhiep	ăn hiếp
batcotroicot	bắt cô trói cột
binhhoa	Bình Hoà
bienlanggioem	biển lặng gió êm
boque	bọ que
boinghieng	bơi nghiêng
benduyen	bén duyên
bebet	bê bết
aobao	áo bào
bailiet	bại liệt
binhkien	Bình Kiến
boncoi	bốn cõi
baitrieucan	bãi triều cạn
boongboong	boong boong
baudat	bầu đất
becgie	béc giê
baohao	bào hao
badaybaytoa	ba dãy bảy toà
baphuoc	bà phước
anhvu	anh vũ
anmy	An Mỹ
betong	bêtông
a-vang-xe	a-văng-xê
boitinh	bội tình
amcong	âm công
amchua	ám chúa
aodaikhandong	áo dài khăn đóng
auhoc	ấu học
biengioi	biên giới
bachlongvi	Bạch Long Vĩ
bahotsuc	ba hột sức
bienthe	biến thể
binhsai	bình sai
annoi	An Nội
anxa	ân xá
be-tongcotthep	bê-tông cốt thép
bocha	bỏ cha
bantandinh	Bàn Tân Định
amvuc	âm vực
batcuoi	bật cười
bacnuoc	bậc nước
aohoa	ảo hóa
amdoan	âm đoạn
babe	Ba Bể
ami	âm ỉ
borao	bờ rào
amti	âm ti
antuchuong	an tức hương
baodanh	báo danh
aouoc	ao ước
andinh	An Định
avao	A Vao
boixuat	bội xuất
bedai	bé dại
ando	ăn dở
bonphan	bón phân
amchoi	ẩm chồi
bosau	bộ sậu
banglang	Bằng Lang
biahop	bia hộp
baxoinhoimotcho	ba xôi nhồi một chõ
bom-bay	bôm-bay
baibien	bãi biển
a-di-xon	A-đi-xơn
bihoan	bi hoan
batrang	Ba Trang
bophaubopco	bóp hầu bóp cổ
bacden	bạc đen
bachdiep	bách diệp
binhtanguongvo	bình tan gương vỡ
bohung	bọ hung
bienphap	biện pháp
ansung	ân sủng
aoxogau	áo xổ gấu
aococ	áo cộc
binhyenvosu	bình yên vô sự
bonmuoi	bốn mươi
annotammat	ăn no tắm mát
bo	bô
benhai	Bến Hải
baovethucvat	bảo vệ thực vật
anlactay	An Lạc Tây
anhlinh	anh linh
ato	ất ơ
bittattay	bít tất tay
anchaodabat	ăn cháo đá bát
anvu	An Vũ
bachqua	bạch quả
bandaugia	bán đấu giá
acngon	ác ngôn
bopmui	bóp mũi
aoso	áo sô
bitmieng	bịt miệng
bequantoacang	bế quan toả cảng
a-mam	a-mam
banhau	bán hầu
baucua	bậu cửa
a-xit	a-xít
baychay	bấy chầy
bongdau	bỗng đâu
an-go-rit	an-gô-rít
a-ni-ong	a-ni-ông
anraynguamieng	ăn ráy ngứa miệng
baoanhvien	bảo anh viện
balo	bá lơ
batphu	bắt phu
bihaikich	bi hài kịch
banhoi	bắn hơi
battam	bặt tăm
behe	be he
bamatmotloi	ba mặt một lời
ancochodoconoi	ăn có chỗ, đỗ có nơi
ba-ri	ba-ri
baytui	bầy tui
bangxang	băng xăng
bolo	bỏ lơ
amoe	ấm oé
baren	baren
binhthuonghoa	bình thường hoá
bat-te	bắt-tê
battinnhiem	bất tín nhiệm
aiki	ái kỉ
boxuyet	bổ xuyết
baoke	bảo kê
batluan	bất luận
acmotcaila	ác (một) cái là
baocaovien	báo cáo viên
bachdauquan	bạch đầu quân
batnhan	bất nhân
boi	bôi
batngansanda	bạt ngàn san dã
bienbiet	biện biệt
bong-xoa	bông-xoa
anchungnoivung	ăn chùng nói vụng
bophongnanhau	bóp họng nặn hầu
baivi	bài vị
banquanh	bàn quanh
aptoi	ập tới
beonhubosutcap	béo như bồ sứt cạp
banhtom	bánh tôm
benaocung	bề nào cũng
ansaungapcanh	ăn sâu ngập cánh
beotay	bèo tây
bakhong	ba không
bannhat	ban nhật
bangtai	băng tải
banmatchodat	bán mặt cho đất
anvungchongno	ăn vụng chóng no
bit-tong	bít-tông
aokhach	áo khách
bathang	ba tháng
batlithan	bất li thân
batsinhbatdiet	bất sinh bất diệt
bachimbaynoi	ba chìm bảy nổi
bochan	bó chân
bothau	bỏ thầu
bietso	biệt số
aiquan	ải quan
anhao	An Hảo
asen	asen
bacdongcan	bắc đồng cân
batchuonchuon	bắt chuồn chuồn
anchayniemphat	ăn chay niệm Phật
bauban	bầu bạn
badau	bã đậu
baoboi	bảo bối
bachdau	bách dầu
baydanthetu	bầy đàn thê tử
bolivar	bolivar
anvi	An Vĩ
bongnguyetxemanh	bóng nguyệt xế mành
banhdau	bánh đậu
batgio	bắt gió
balong	balông
bienthan	biện thần
batronbatrao	ba trợn ba trạo
amohoite	ấm ớ hội tề
au	ấu
anguyen	á nguyên
banhong	ban hồng
anban	an bần
bocbanhchangduocdinhtay	bóc bánh chẳng được dính tay
banvichunghia	bản vị chủ nghĩa
bolidau	bộ li dầu
bienchungphap	biện chứng pháp
banbiu	bấn bíu
ammao	âm mao
binhhoahung	Bình Hoà Hưng
ba-truiba-tui	ba-trui, ba-tui
batdiet	bất diệt
ancuoc	ăn cuộc
ben	bên
banhutro	bánh ú tro
bangtiep	bàng tiếp
baquexola	ba que xỏ lá
anvanganbacgi	ăn vàng ăn bạc gì
amnhai	âm nhai
bec-gie	béc-giê
batrui	batrui
anlua	ăn lửa
babichinquaimuoihaiconmat	ba bị chín quai mười hai con mắt
bongduong	bóng dương
banghuuchigiao	bằng hữu chi giao
binhtrungtay	Bình Trung Tây
banthiu	bẩn thỉu
annhon	An Nhơn
bachhau	bạch hầu
bachtueviki	bách tuế vi kì
anoan	ân oán
a-lec	a-léc
anhienolanh	ăn hiền ở lành
bangiang	Bản Giang
bot-can	bốt-can
aceton	aceton
bomay	bộ máy
andungone	ăn dưng ở nể
binhluong	Bình Lương
biadabangvang	bia đá bảng vàng
andaunamnho	ăn đậu, nằm nhờ
bonglong	bông lông
bannhanvenmay	bắn nhạn ven mây
binhtam	bình tâm
bolao	bô lão
boanmathidabohay	bò ăn mạ thì dạ bò hay
baochuavien	bào chữa viên
annhutranglamnhulao	ăn như tráng, làm như lão
bebao	bẻ bão
banhquanthung	bánh quấn thừng
aomang-to	áo măng-tô
anhoangphahoai	ăn hoang phá hoại
anthach	An Thạch
a-xitbeo	a-xít béo
anhhungcaithe	anh hùng cái thế
binhnhat	binh nhất
banphanbuonson	bán phấn buôn son
batrieu	Bà Triệu
binhnguyen	bình nguyên
bangmau	bảng màu
aonau	áo nậu
bonglon	bông lơn
a-xitsun-fu-ric	a-xít sun-fu-ric
bachi	ba chỉ
anlan	ăn lấn
baolac	Bảo Lạc
baotieu	bao tiêu
boihoan	bồi hoàn
binhnhi	binh nhì
anhhungnhatkhoanh	anh hùng nhất khoảnh
bantoa	bàn tọa
binhnguyen	Bình Nguyên
bovi	bố vi
aokep	áo kép
beodathoatroi	bèo dạt hoa trôi
botuong	bộ tướng
bai	bài
anlan	ăn lan
a-la-vang	a-la-văng
boteo	bồ tèo
anhoi	ăn hỏi
binhche	binh chế
anthua	ăn thừa
bietco	biết có
antieu	ăn tiêu
binhthe	binh thế
bangnhac	băng nhạc
bar	bar
bidong	biđông
batdibatdich	bất di bất dịch
andoimacret	ăn đói mặc rét
baybot	bấy bớt
anvinhngai	An Vĩnh Ngãi
bang-ca	băng-ca
baoquang	Bảo Quang
bontay	bốn tay
baimang	bái mạng
beomieng	béo miệng
bietxu	biệt xứ
bavinh	Ba Vinh
baynui	Bảy Núi
batacluoi	ba tấc lưỡi
bebai	bẻ bai
anhao	ân Hảo
bietmuichuichangsach	biết mùi chùi chẳng sạch
bagiang	ba giăng
baylong	bẫy lồng
ancanoro	ăn càn ở rỡ
boctuechboctoac	bộc tuệch bộc toạc
bombop	bôm bốp
bocao	bồ cào
bithu	bì thư
ainghia	ái Nghĩa
bi	Bi
bietmu	biệt mù
aithiep	ái thiếp
anchaynamdat	ăn chay nằm đất
ba-xiba-tu	ba-xí ba-tú
bachai	Bắc Hải
a-lo	a-lô
annonguki	ăn no ngủ kĩ
angia	ân gia
battoi	bắt tội
bansechuathuangiuongna	bắn sẻ chưa thuận giương ná
bachkhoathuchuyennganh	bách khoa thư chuyên ngành
batmeo	bắt mẹo
binhsu	binh sự
batchanchungu	bắt chân chữ ngũ
adau	ả đầu
bodai	bồ đài
bomon	bộ môn
bongnga	bóng nga
bebe	bê bê
bacobopconchau	bà cô bóp con cháu
bothua	bờ thửa
bacnhuvoi	bạc như vôi
baola	Bao La
anmankhatnuoc	ăn mặn khát nước
batienbathocbacocgiai	bà tiền, bà thóc, bà cóc gì ai
bangduattuongtri	bạng duật tương trì
balanbayluot	ba lần bảy lượt
an-gin	an-gin
betuhoai	bể tự hoại
banngaybanmat	ban ngày ban mặt
bitbung	bít bưng
bom	bôm
bacquang	Bắc Quang
aomo	áo mớ
bieusinh	biểu sinh
banhchoe	bảnh chọe
bata	bata
botrietam	bộ triệt âm
banggia	băng giá
a-ta-tin	a-ta-tin
beonuochoptan	bèo nước hợp tan
bamviu	bám víu
binhhoatrung	Bình Hoà Trung
baomieng	bạo miệng
baubiu	bâu bíu
bengan	bền gan
banhtrongbanhloc	bánh trong bánh lọc
boinhi	bội nhị
anphanthuki	an phận thủ kỉ
ba-ke-lit	ba-ke-lit
binhxuan	Bình Xuân
banhchoe	bảnh choẹ
boctuech	bộc tuệch
beotoong	bèo tổ ong
bikihoc	bi kí học
batnuingandoi	bạt núi ngăn đồi
boihoi	bổi hổi
bacchuathaucanhdachaylang	bạc chửa thâu canh đã chạy làng
batkhatri	bất khả tri
baoloan	bạo loạn
bai	bai
anninh	an ninh
benxe	bến xe
antoa	an toạ
boxuong	bộ xương
batcanthiep	bất can thiệp
aobo-lu-dong	áo bờ-lu-dông
aocoi	áo cối
ba	Ba
bogiamthanh	bộ giảm thanh
anhemthucba	anh em thúc bá
bietdanh	biệt danh
biubiu	bìu bịu
boi	bội
baituong	bái tướng
bombuom	bom bướm
anngoi	ăn ngồi
banhxuxe	bánh xu xê
at-mot-phe	át-mốt-phe
am	am
baluabayloc	ba lừa bảy lọc
botnhao	bột nhão
bienchep	biên chép
baichai	bài chài
banthuong	ban thưởng
bophau	bóp hầu
amngua	ẵm ngửa
anguinamcho	ăn gửi nằm chờ
bedicaulondihau	bé đi câu, lớn đi hầu
bebau	bể bầu
boidaura	bói đâu ra
baituc	bại tục
bobe	bỏ bê
anay	à này
bosau	bộ sáu
anbeo	ăn bẻo
an-tra-xit	an-tra-xít
bieutrung	biểu trưng
amvat	âm vật
aidoi	ai đời
aovong	ảo vọng
bienthuat	biên thuật
beotaituong	bèo tai tượng
amtap	âm tạp
biethieu	biệt hiệu
bautuong	bậu tường
anlan	ăn lận
bichquy	bích quy
bondaihaingan	bốn dài hai ngắn
boidaisuc	bơi dai sức
baigiang	bài giảng
bemo	bẹ mo
baymuutinhke	bày mưu tính kế
batgiac	bất giác
boiolodi	bồi ở, lở đi
andaulamkhoan	ăn đấu làm khoán
batan	bất an
aotang	áo tang
baythuo	bấy thuở
bachphuclinh	bạch phục linh
bochanbotay	bó chân bó tay
bachhuyetcau	bạch huyết cầu
bientra	biến trá
baolam	bao lăm
batuan	ba tuần
bietgi	biết gì
benno	bên nớ
baoranh	bào rãnh
bambam	băm băm
baungoc	báu ngọc
aoba	áo bả
anhtu	anh tú
anchucnamcho	ăn chực nằm chờ
bao	bạo
axitaxetic	axit axetic
antrabua	ăn trả bữa
bacnhipcauo	bắc nhịp cầu ô
anthanhthuy	An Thạnh Thuỷ
anhoa	An Hoà
bangtam	băng tâm
andung	ăn đụng
ang-ti-gon	ăng-ti-gôn
baodong	bạo động
baoanbaooan	báo ân báo oán
antrach	ân trạch
bongram	bóng râm
bacphong	bắc phong
anbangnoichac	ăn bằng nói chắc
baoxa	bao xa
banhkhoai	bánh khoai
banhtruong	bành trướng
anbaynoican	ăn bậy nói càn
anmayquenngo	ăn mày quen ngõ
a-pa-tit	a-pa-tít
baochiem	bao chiếm
bacson	Bắc Sơn
biadodan	bia đỡ đạn
bodai	bò dái
benhbachcau	bệnh bạch cầu
bongpheng	bông phèng
botsam	bột sam
bangoi	Ba Ngòi
baclan	bạc lan
bidai	bí đái
binhnhung	binh nhung
bayba	bậy bạ
bientuong	biến tượng
bancondi	bạn con dì
baohoa	Bảo Hoà
anhanh	anh ánh
binhhai	Bình Hải
baoly	Bảo Lý
anxoi	ăn xổi
beohopmaytan	bèo hợp mây tan
be-ri-li	be-ri-li
a-xita-xe-tic	a-xít a-xê-tic
boi	bối
baibong	bài bông
baydat	bày đặt
binhphongthanh	Bình Phong Thạnh
bongbac	bông bạc
banchiu	bán chịu
batchangduocthalamphuc	bắt chẳng được tha làm phúc
bisactuphong	bỉ sắc tư phong
achau	á châu
baychu	bảy chữ
anhkiet	anh kiệt
batquyet	bắt quyết
aodonlongaokep	áo đơn lồng áo kép
boloi	bỏ lơi
boray	bọ rầy
biensuxu	biện sự xứ
bo	bo
andogiao	ấn độ giáo
banxoa	bàn xoa
anhdao	anh đào
angio	ăn giơ
banhuu	bạn hữu
baycoke	bẫy cò ke
beobeu	béo bệu
baoquoc	báo quốc
a-ga	a-ga
bithiet	bi thiết
baichay	Bãi Cháy
bongonhurovedongbang	bỡ ngỡ như rợ về đồng bằng
baychuyen	bày chuyện
beduoi	bề dưới
binhda	Bình Đa
bichhoa	bích họa
boqua	bỏ quá
anchodeukeuchosong	ăn cho đều, kêu cho sòng
bachiem	bá chiếm
bochidao	bọ chỉ đào
acqui	ác quỉ
bedausuttran	bể đầu sứt trán
bonhoai	bổ nhoài
basuongmotnang	ba sương một nắng
binhsinh	bình sinh
botui	bỏ túi
akhau	á khẩu
banke	bản kê
behanhbetoi	bẻ hành bẻ tỏi
anvoi	ăn vòi
bienchung	biến chủng
ap-xe	áp-xe
aocom	áo cơm
amdem	âm đệm
bechuoi	bẹ chuối
bolaoboleu	bố láo bố lếu
angialamthat	ăn giả làm thật
banphiet	Bản Phiệt
bieutuong	biểu tượng
bangngoc	băng ngọc
batgiu	bắt giữ
bebe	be be
battay	bắt tay
bala	ba la
ankhop	ăn khớp
babau	bà bầu
bienchuyen	biến chuyển
biamieng	bia miệng
boy	bố y
anbaoco	ăn báo cô
batquaitrando	bát quái trận đồ
bolao	bổ lao
batkham	bất kham
bachkhoa	Bách Khoa
baudon	Bàu Đồn
aoi	à ơi
a-sen	a-sen
ansinh	An Sinh
bienbach	biện bạch
aha	a ha
banlui	bàn lùi
binhgiang	Bình Giang
aho	a hộ
bonhao	bổ nháo
banhkhao	bánh khảo
bathao	bất hảo
bagai	ba gai
binhminh	Bình Minh
anbinh	ăn bĩnh
anngu	ăn ngữ
boxo	bơ xờ
anoanrachroi	ân oán rạch ròi
aobong	áo bông
banghieu	bảng hiệu
agiao	a giao
anhuonghoa	ăn hương hoả
annhi	ân nhi
boquen	bỏ quên
baothan	bạo thần
andong	ăn đong
binhthuy	Bình Thuỷ
bauruoutuitho	bầu rượu túi thơ
apsuatkhiquyen	áp suất khí quyển
bacloan	bác loạn
antri	an trí
axit	a xít
boiroinhubasude	bối rối như bà sư đẻ
banphongkien	bán phong kiến
boibut	bồi bút
anlanh	an lành
anghem	ăn ghém
binhtuyen	bình tuyển
ango	ăn gọ
beoday	béo đẫy
bau	bâu
baovu	báo vụ
a-mi-ang	a-mi-ăng
binhson	Bình Sơn
antaianhoi	ăn tái ăn hồi
bankhen	ban khen
batthucthoi	bất thức thời
boico-ron	bơi cơ-rôn
bacnhuran	bạc như rận
baotuong	bao tượng
angketang-ket	ăng két, ăng-kết
babi	ba bị
anbinhbatdong	án binh bất động
bongong	bọng ong
battai	bạt tai
bachung	Bắc Hưng
babebaymoi	ba bè bảy mối
baocai	bảo cái
bonheobonhoc	bồ nheo bồ nhóc
banh-to	bành-tô
amtuong	am tường
aicam	ai cảm
benhtuong	bệnh tưởng
binhguong	bình gương
baocat	bão cát
boimo	bôi mỡ
bacocbadong	ba cọc ba đồng
am-pe	ăm-pe
anbanlacdao	an bần lạc đạo
binhthien	bình thiên
baitrieu	bãi triều
bombe	bom bê
baophong	bạo phong
bongluoi	bông luồi
antrien	ấn triện
bacung	ba cùng
boigiotrattrau	bôi gio trát trấu
bachoaxoe	bạc hoa xoè
beu	bệu
anhietdoi	á nhiệt đới
amhieu	ám hiệu
battuongxam	bất tương xâm
banhoa	bán hoa
alumin	alumin
ap-ga-ni	áp-ga-ni
bieubi	biểu bì
batcocbodia	bắt cóc bỏ đĩa
aosomi	áo sơ mi
bonghia	bổ nghĩa
biengiang	Biên Giang
balangnhang	ba lăng nhăng
ac-tennongnghiep	ác-ten nông nghiệp
apgia	áp giá
benlau	bền lâu
acmotnoila	ác (một) nỗi là
ancomvoicaythingayooancomvoithitbothilongayngay	ăn cơm với cáy thì ngáy o o, ăn cơm với thịt bò thì lo ngay ngáy
bacbaccaoki	bắc bậc cao kì
amcatnolong	ấm cật no lòng
boroi	bỏ rơi
bangia	bạn già
batchuoc	bắt chước
bantongbanthao	bán tống bán tháo
a-da	a-đa
bamua	ba mứa
anchac	ăn chắc
amtham	âm thầm
angoinamnho	ăn gởi nằm nhờ
anthinh	An Thịnh
anquanh	ăn quanh
boisontratphan	bôi son trát phấn
baotanghoc	bảo tàng học
bogiap	bó giáp
anquang	An Quang
a-ba-giua	a-ba-giua
adhoc	ad hoc
boi	bỏi
batam	bát âm
amchinh	âm chính
bietthu	biệt thự
bocthom	bốc thơm
batngoai	bất ngoại
bannuocbuondan	bán nước buôn dân
baosan	bao sân
atropin	atropin
bazan	bazan
benhcan	bệnh căn
beobui	béo bùi
beonuocgapnhau	bèo nước gặp nhau
aothung	áo thùng
bonhurua	bò như rùa
batnhaochikhuon	bát nháo chi khươn
batcong	bất công
amcao	âm cao
acidbeo	acid béo
baotang	bảo tàng
botruong	bộ trưởng
bongxo	bông xơ
baoan	bảo an
al	Al
boptampho	bóp tầm phơ
boiden	bôi đen
bonong	bồ nông
a	A
bemieng	bé miệng
bochomuabac	bọ chó múa bấc
boxu	bô xu
banhga-to	bánh ga-tô
baoanh	báo ảnh
bocuoc	bỏ cuộc
becainham	bé cái nhầm
beotia	bèo tía
boplung	bóp lưng
a-vi	a-vi
amtinh	âm tính
bienli	biện lí
banlau	Bản Lầu
baninthu	bản in thử
binhtamtinhkhi	bình tâm tĩnh khí
boithu	bội thu
boicanh	bối cảnh
aogamdidem	áo gấm đi đêm
boigiao	bội giáo
aochen	áo chẽn
baivan	bài văn
balong	ba lông
betagochuno	bè ta gỗ chú nó
bavuongsanhvoibaytron	ba vuông sánh với bảy tròn
beplanhtrotan	bếp lạnh tro tàn
auau	au au
bachkhoathu	bách khoa thư
bayto	bày tỏ
aonep	áo nẹp
bomombomieng	bó mồm bó miệng
amhach	âm hạch
anvungbovai	ăn vung bỏ vãi
bosinh	Bó Sinh
ankiem	ấn kiếm
banrao	Bản Rao
backhe	Bắc Khê
abung	A Bung
anno	ăn no
borayxanh	bọ rầy xanh
andoi	ăn dối
bonheobonhoc	bò nheo bò nhóc
aotam	áo tắm
amchuyen	ấm chuyên
bothuasuacan	bơ thừa sữa cặn
bieudat	biểu đạt
angionammua	ăn gió nằm mưa
bangnhan	băng nhân
bentren	bên trên
baunhaubaunhau	bảu nhảu bàu nhàu
bangkhuang	bâng khuâng
banlao	ban lao
aotuthan	áo tứ thân
bamnhudia	bám như đỉa
biendieu	biến điệu
botu	bộ tư
bacung	Ba Cung
beomo	béo mỡ
amhai	ám hại
bennoi	bên nội
batsoncudinh	bạt sơn cử đỉnh
amphong	âm phong
banin	bản in
bannay	ban nãy
aocau	áo cầu
annghia	ân nghĩa
batan	bát ăn
anphe	án phê
alo	alô
banranoivao	bàn ra nói vào
aiquoc	ái Quốc
bangtuanhoan	bảng tuần hoàn
anhnuoi	anh nuôi
bachopbaynhoang	ba chớp bảy nhoáng
boluoi	bổ lưới
bopcobophau	bóp cổ bóp hầu
boiroiruottam	bối rối ruột tằm
bang-gio	băng-giô
bansen	Bản Sen
banhtaivoi	bánh tai voi
banhcucai	bánh củ cải
banghinh	băng hình
bientoc	biến tốc
baohanh	bảo hành
binhloi	Bình Lợi
aochet	áo chét
bakich	ba kích
anla	ăn lá
batoong	ba toong
bitien	bì tiên
ankhao	ăn khao
baoden	báo đền
battambattich	bặt tăm bặt tích
bayhoi	bay hơi
bithuong	bị thương
binhxuong	binh xưởng
bachthiet	bách thiết
binhcu	bình cư
anduongvuong	An Dương Vương
bieucam	biểu cảm
bonphuong	bốn phương
antap	ăn tạp
baocu	bảo cử
beobeo	beo béo
binhdien	bình điện
ano	ăn ở
baxuan	ba xuân
bachdau	bạch đầu
bantinbannghi	bán tín bán nghi
bacay	ba cây
banmuuhoachke	bàn mưu hoạch kế
ancanngoike	ăn cận ngồi kề
bangdoibanglua	bằng đôi bằng lứa
baccucquyen	bắc cực quyền
bochao	bồ chao
bogio	bó giò
bangiamhieu	ban giám hiệu
ba-te-so	ba-tê-sô
boireconhonngoikhong	bói rẻ còn hơn ngồi không
basalt	basalt
biencach	biến cách
bangdao	băng đảo
baorot	bão rớt
anbot	ăn bớt
baophu	bao phủ
beonoimaychim	bèo nổi mây chìm
beobot	bèo bọt
beodau	bèo dâu
bitham	bi thảm
bienho	biển hồ
aunhi	ấu nhi
bisau	bi sầu
aosogau	áo sổ gấu
baoquanh	bao quanh
babuacomchin	ba bữa cơm chín
baotu	bão từ
benbai	bến bãi
bientinh	biến tính
bankhuyen	bán khuyên
binhtrung	Bình Trưng
banvang	ban vàng
batbong	bật bông
battin	bặt tin
baoyen	Bảo Yên
bantoimattoimui	bận tối mắt tối mũi
boithe	bội thệ
anchung	ăn chung
bachonbonnoi	ba chốn bốn nơi
an-de-hit	an-đê-hít
bocu	bồ cu
ankiengankhem	ăn kiêng ăn khem
anthan	an thân
baoquan	bao quản
binhdoi	binh đội
batloi	bắt lỗi
anthai	An Thái
boitham	bồi thẩm
bauviu	bấu víu
ango	A Ngo
anngapmatngapmui	ăn ngập mặt ngập mũi
bobo	bô bô
baitoan	bài toán
bongbut	bông bụt
bidup	Bi Đup
ankhoa	ân khoa
badao	bá đạo
andatnamsuong	ăn đất nằm sương
baotudiep	bào tử diệp
bienvien	biên viễn
banphuam	bán phụ âm
ambinh	âm binh
anduongnamcho	ăn đường nằm chợ
anmung	ăn mừng
bangla	Bằng La
bale	Ba Lê
an-ma-nac	an-ma-nác
boitinh	bội tinh
bietthi	biệt thị
adau	a đẩu
aongu	áo ngự
bongua	bổ ngửa
biai	bi ai
binhcau	bình cầu
binhsa	Bình Sa
anlac	An Lạc
amvap	Am Váp
banvuoc	Bản Vược
benhcanhoc	bệnh căn học
anduongduong	an dưỡng đường
anmamngamvesau	ăn mắm ngắm về sau
angiacnganthu	an giấc ngàn thu
bachacay	bạc hà cay
basansang	ba sẵn sàng
bochihuy	bộ chỉ huy
anvung	ăn vụng
bobai	bơ bải
ankhe	An Khê
botxuong	bột xương
apgiai	áp giải
bophieu	bỏ phiếu
boiroinhutovo	bối rối như tơ vò
botucvanhoa	bổ túc văn hoá
bachgiai	bách giải
bonglaitiencanh	bồng lai tiên cảnh
benhoibentieng	bén hơi bén tiếng
amchuong	ám chướng
amaamuc	ấm a ấm ức
boi	bồi
baitranh	Bãi Trành
aihuu	ái hữu
benbo	bên bờ
binhquandiaquyen	bình quân địa quyền
aikhanh	ái khanh
bato	Ba Tô
boisuat	bội suất
ammon	âm môn
betong	bê tông
banhdua	bánh dừa
antheo	ăn theo
banhsapdibanhchilai	bánh sáp đi, bánh chì lại
bahoa	ba hoa
bienlai	biện lại
bomdan	bom đạn
baogoi	bao gói
baunang	Bàu Năng
anthonoituc	ăn thô nói tục
boba	bộ ba
bathac	ba thắc
bacnuocchogaonguoi	bắc nước chờ gạo người
boicho	bơi chó
bienson	Biên Sơn
annoi	ăn nổi
banthien	bàn thiên
bomphong	bom phóng
apsuattieuchuan	áp suất tiêu chuẩn
bongchanhbocchach	bòng chanh bóc chách
aobaogapngayhoi	áo bào gặp ngày hội
anxin	ăn xin
anhuonganhoa	ăn hương ăn hoa
binhngung	bình ngưng
batloi	bắt lời
anhhai	anh hài
baigiai	bài giải
baihuong	bài hương
bongong	bộng ong
betongcotthep	bêtông cốt thép
aosongkhai	áo song khai
ban-gio	ban-giô
boquan	bồ quân
bahang	Ba Hàng
aichi	ai chỉ
binhgia	bình giá
aphien	ả phiện
bietthanbietphan	biết thân biết phận
betaybutngayram	bẻ tay bụt ngày rằm
baunhiethuyet	bầu nhiệt huyết
beomap	béo mập
anhruot	anh ruột
bay	bấy
banhxe	bánh xe
bang-tup	băng-túp
bonbienlanha	bốn biển là nhà
apsuattoihan	áp suất tới hạn
anbuasanglanbuatoi	ăn bữa sáng lần bữa tối
biu	bĩu
anchangnokhodenminh	ăn chẳng no, khó đến mình
anngaitay	An Ngãi Tây
anthatlamgia	ăn thật làm giả
bole	bò lê
a-mo-ni-ac	a-mô-ni-ác
baichoi	bài chòi
bomothithieubochieuthithua	bó mo thì thiếu, bó chiếu thì thừa
benhnhi	bệnh nhi
binhchuachay	bình chữa cháy
betrieu	Bế Triều
ankhang	an khang
bocchay	bốc cháy
azot	azot
batphanthangbai	bất phân thắng bại
bonchon	bôn chôn
anchuanolochuaden	ăn chưa no, lo chưa đến
bongcau	bóng câu
anmotbatchaochaybaquangdong	ăn một bát cháo chạy ba quãng đồng
aodaikhanluot	áo dài khăn lượt
bannhuvaicat	bắn như vãi cát
bienca	biển cả
bairac	bãi rác
angionamsuong	ăn gió nằm sương
baoche	bào chế
biubo	bíu bo
baikien	bái kiến
bangdai	băng đai
bangtreo	băng tréo
banhtay	bánh tày
aa	â, Â
bangden	bảng đen
batieu	Ba Tiêu
binhan	bỉ nhân
bokhong	bỏ không
anmy	ân Mỹ
behoe	bẻ họe
a-tu-la	a-tu-la
binhthan	bình thân
bacninh	Bắc Ninh
bangxepdong	băng xếp đống
beboi	bê bối
amno	ấm no
baumat	bạu mặt
bovo	bơ vơ
banngoibanthu	bán ngôi bán thứ
ancomnhavactuvahangtong	ăn cơm nhà, vác tù và hàng tỗng
banbuitredenhebuihop	bắn bụi tre đè (nhè) bụi hóp
ancutkhongbietthoi	ăn cứt không biết thối
baihoai	bải hoải
bancua	ban cua
bienthanh	biên thành
baohoang	bảo hoàng
aohoangbao	áo hoàng bào
aobanhto	áo bành tô
baylabaychuyen	bay la bay chuyền
amdiem	ám điểm
anduong	ấn đường
beongay	béo ngậy
boktoi	Bok Tới
acquanmandoanh	ác quán mãn doanh
anbacmackinh	ăn bắc mặc kinh
baoduocnao	bảo được nào
bautroi	bầu trời
bo	Bo
a-mang	a-măng
binhhoatay	Bình Hoà Tây
bay	bẩy
binhchau	Bình Châu
baochua	bạo chúa
ano	ăn ở
beophe	béo phệ
binhduong	Bình Dương
anchuanolochuathau	ăn chưa no lo, chưa thấu
apatit	apatit
aotrao	áo trào
banthannuoimieng	bán thân nuôi miệng
anthaidong	An Thái Đông
baotu	bao tử
amvang	ầm vang
bangluan	Bằng Luân
baynhay	bấy nhấy
ango	ăn gỗ
bangdabangthit	bằng da bằng thịt
bieutu	biểu tự
bapdui	bắp đùi
bembep	bem bép
aibao	ai bảo
benbi	bên bị
ailai	ai lại
baibac	bài bạc
bauham	Bàu Hàm
aodaycomnang	áo dày cơm nặng
banbuon	bán buôn
axeton	axeton
ang-to-ra-xit	ăng-tơ-ra-xit
bienngau	biền ngẫu
battran	bát trân
annan	ăn năn
a-tro-pin	a-trô-pin
anthamnhugau	ăn tham như gấu
banhmuot	bánh mướt
anduong	an dưỡng
aomoi	áo mồi
bangvesinh	băng vệ sinh
amcung	âm cung
batnganmanda	bạt ngàn man dã
bauducchammamcay	bầu dục chấm mắm cáy
aitu	ai tử
banchieu	ban chiều
bienngoi	biến ngôi
banhoagia	bán hoá giá
bailam	bài làm
banquan	bản quán
banmai	ban mai
bahien	Bá Hiến
amvaothan	ấm vào thân
aonhong	áo nhộng
badaunam	ba đậu nam
apacthai	a pác thai
anle	ăn lễ
bocoibocut	bồ côi bồ cút
baisan	bại sản
bacthuoc	bắc thuộc
begay	bẻ gãy
bamdotngontay	bấm đốt ngón tay
benle	bên lề
boiduc	bồi dục
axitamin	axit amin
annodungmo	ăn no dửng mỡ
bangtup	băng túp
bomlua	bom lửa
betbe	bét be
bangphien	băng phiến
binhan	Bình An
baoxiet	bao xiết
anboc	ăn bốc
anson	ân Sơn
bangcandoi	bảng cân đối
boimat	bôi mặt
bacnam	bắc nam
antuong	An Tường
bochuongtrinhchuyendung	bộ chương trình chuyên dụng
bankhai	bán khai
beonhuconcuncut	béo như con cun cút
bazo	bazơ
amnang	âm nang
banlang	Bản Lang
bieuthue	biểu thuế
bonbien	bốn biển
bibabibo	bí ba bí bô
baubau	bàu bạu
bolekeocang	bò lê kéo càng
bopcoi	bóp còi
baoliet	bạo liệt
banhchungragoc	bánh chưng ra góc
banglang	bằng lăng
banhcuon	bánh cuốn
anphudong	An Phú Đông
betho	bé thơ
bobinh	bộ binh
bogiot	Bỏ giọt
a-mi-dan	a-mi-đan
bentau	bến tàu
baituong	bại tướng
beomat	béo mắt
baodong	báo động
batthanhnhancach	bất thành nhân cách
anqua	ăn quà
annhan	an nhàn
bongdua	bông đùa
bidinh	bi đình
baugiathimuopcungxo	bầu già thì mướp cũng xơ
binhlang	Bình Lăng
bietthoibietthe	biết thời biết thế
baorong	bão rong
binhnhan	Bình Nhân
anh-te-phon	anh-te-phôn
bongda	bong da
aococquanmanh	áo cộc quần manh
boitruc	bồi trúc
bachua	Ba Chùa
annhucungunhuxua	ăn như cũ, ngủ như xưa
andananhlamdanem	ăn đàn anh, làm đàn em
anvan	ăn vận
baode	bào đệ
binhdoan	binh đoàn
bietdongdoi	biệt động đội
bo	bơ
biemhoa	biếm họa
box	box
aobay	áo bay
ancungnoingoicungchieu	ăn cùng nồi, ngồi cùng chiếu
bolan	bò lan
bay-on-net	bay-on-nét
benme	bến mê
benhtamthan	bệnh tâm thần
battreo	bắt tréo
binhlua	binh lửa
batoto	bát ô tô
binhvu	binh vụ
amba	âm ba
bentinhbenhieu	bên tình bên hiếu
bamuoi	ba mươi
balien	Ba Liên
bacdauboitinh	bắc đẩu bội tinh
aodondoihe	áo đơn đợi hè
ancaynaoraocayay	ăn cây nào rào cây ấy
bathocdientuong	bất học diện tường
bainai	bãi nại
bahoi	ba hồi
bansinhbanthuc	bán sinh bán thục
bangngan	băng ngàn
batang	Ba Tầng
aodau	áo dấu
at-pi-rin	át-pi-rin
baoho	bảo hộ
botbeo	bọt bèo
binhhungtuongmanh	binh hùng tướng mạnh
biatuoi	bia tươi
baiquan	bại quân
boda	bọ da
bangghi	bảng ghi
banhdanem	bánh đa nem
anquan	ăn quân
biettong	biết tỏng
baoliep	báo liếp
antu	ân tứ
anxuan	An Xuân
bode	bô đê
bi-tum	bi-tum
binhbi	binh bị
achiem	ác hiểm
bachuc	Ba Chúc
bogia	bõ già
baocong	báo công
anbon	ăn bòn
baoanh	bảo anh
ancanhnamke	ăn cạnh nằm kề
bonhambonhiem	bổ nhậm, bổ nhiệm
bongua	bộ ngựa
binhcong	bình công
bodoichuluc	bộ đội chủ lực
bantin	bản tin
bovay	bổ vây
anhhunglucluongvutrang	anh hùng lực lượng vũ trang
amthanhcanhvang	am thanh cảnh vắng
baihai	bải hải
apchao	áp chảo
amvan	âm vận
bihung	bi hùng
anhaidainat	ăn hại đái nát
bangha	băng hà
baydau	bay đầu
baitap	bài tập
bacdoat	bác đoạt
baovequan	bảo vệ quân
baivat	bái vật
boong	boóng
bovonhucholacdan	bơ vơ như chó lạc đàn
bai	bái
banbiu	bận bịu
ananh	ăn ảnh
bantrang	bàn trang
binhthuong	bình thường
apphe	áp phe
bauducdaudenbanthunam	bầu dục đâu đến bàn thứ năm
banchuimatchuimui	bận chúi mắt chúi mũi
bacumnam	Ba Cụm Nam
anre	ăn rễ
bis	bis
banbo	ban bố
bihai	bi hài
aomayo	áo may ô
ac-ti-so	ác-ti-sô
bo-lu-dong	bờ-lu-dông
bongngoai	bổng ngoại
boso	bơ sờ
bancunghoa	bần cùng hoá
bayganbayruot	bẩy gan, bẩy ruột
bemontakhach	bế môn tạ khách
binhphap	binh pháp
bongtang	bồng tang
anninhtay	An Ninh Tây
anlai	ăn lãi
antranghiaden	ân trả nghĩa đền
bithuat	bí thuật
bangtro	bang trợ
beotron	béo tròn
anhuong	an hưởng
binhhoa	binh hoạ
bangkhong	bằng không
bieuhien	biểu hiện
bache	Ba Chẽ
binhhoabac	Bình Hoà Bắc
baiphuc	bái phục
batdia	bát đĩa
ankhongnoico	ăn không nói có
bocong	bõ công
bientai	biên tái
baoquan	bào quan
bangdia	bằng địa
anductay	An Đức Tây
bieukien	biểu kiến
aothunla	áo thun lá
bequantoacang	bế quan tỏa cảng
authuyen	âu thuyền
annghia	ân Nghĩa
binhvoguongtan	bình vỡ gương tan
banconong	bần cố nông
batngua	bật ngửa
baylau	bấy lâu
a-zot	a-zốt
amben	âm bên
banhtrungthu	bánh Trung thu
amtiet	âm tiết
anbien	an biên
anchuc	ăn chực
bacotnguimuitanhuong	bà cốt ngửi mùi tàn hương
anminh	An Minh
ainay	ai nấy
amxiu	ẩm xìu
binhnam	Bình Nam
an-ca-lo-it	an-ca-lo-ít
bannao	bàn nạo
babayhaimuoimot	ba bảy hai mươi mốt
amduc	âm đức
bachanboncang	ba chân bốn cẳng
ancuoi	ăn cướì
banhtay	bánh tây
baoquan	bạo quân
anbinha	An Bình A
banglan	băng lăn
baothuan	Bảo Thuận
biluy	bi luỵ
bamgantimruot	bầm gan tím ruột
antuoi	ăn tươi
banthu	ban thứ
bicao	bị cáo
boiphong	bồi phòng
binhquy	Bình Quý
acidamin	acid amin
baosa	bao sá
bachmaocan	bạch mao căn
booc-do	boóc-đô
anchungolon	ăn chung ở lộn
acqua	ác quả
bolabolet	bò la bò lết
beoxu	béo xụ
binhcuruoumoi	bình cũ rượu mới
bienhoa	Biên Hoà
benmui	bền mùi
bocaobutnomacchobutkia	bóc áo bụt nọ mặc cho bụt kia
binhuy	binh uy
bietlap	biệt lập
boichinh	bội chỉnh
banqua	Bản Qua
beobo	béo bở
bausao	bầu sao
bomna-pan	bom na-pan
bandien	bạn điền
benh	bênh
bauvat	báu vật
anchia	ăn chia
bephai	bè phái
bacphau	bạc phau
baonguoc	bạo ngược
bandao	bàn dao
banhbotdau	bánh bột đậu
badong	Ba Động
ankhonganhong	ăn không ăn hỏng
baotoc	bào tộc
anduong	ăn đường
batcannhantinh	bất cận nhân tình
banaobanhien	bán ảo bán hiện
ao-xo	ao-xơ
banhtrungthu	bánh trung thu
anloidong	An Lợi Đông
anquanghuu	An Quảng Hữu
aongangiuchangnendai	áo ngắn giũ chẳng nên dài
bantia	bắn tỉa
binhgia	binh gia
a-no-phen	a-nô-phen
annho	ăn nhờ
binhnghiep	binh nghiệp
bacthai	Bắc Thái
bombuombuom	bom bươm bướm
bamun	Ba Mùn
bihoai	bi hoài
bannuoc	bán nước
bieuduong	biểu dương
biengbiec	biêng biếc
aimo	ái mộ
baoton	bảo tồn
bacgiay	bạc giấy
bailinh	bái lĩnh
boithuong	bồi thường
banhxeo	bánh xèo
bau	bậu
am-mo-ni-ac	am-mô-ni-ắc
bo-bin	bô-bin
baohoa	bao hoa
bamuoisauchuoc	ba mươi sáu chước
bonmua	bốn mùa
ag	Ag
anap	An ấp
alao	á lao
bocoi	bồ côi
aihuuhoi	ái hữu hội
banbotauenhuong	bán bò tậu ễnh ương
bainieu	bài niệu
baoan	Bảo An
aogamvelang	áo gấm về làng
bophongsinh	bỏ phóng sinh
aogam	áo gấm
bachcong	bách công
baitinh	bài tính
boghi	bộ ghi
angiobotrau	ăn gio bọ trấu
bamgay	bấm gáy
baikhoa	bãi khóa
andat	ăn đất
bao	bào
besuon	bẹ sườn
amduongcachbiet	âm dương cách biệt
as	As
aonao	ảo não
bienluan	biện luận
benangchongtroi	bẻ nạng chống trời
banhkhoai	bánh khoái
bangchannhuvai	bằng chân như vại
ao	ao
bongbachcau	bóng bạch câu
achdui	ạch đụi
bangac	Ba Ngạc
antrenngoitroc	ăn trên ngồi trốc
auco	âu Cơ
banthan	bản thân
anxoichuangongmieng	ăn xôi chùa ngọng miệng
bieu	biếu
botham	bỏ thăm
bongdai	bóng đái
boithuc	bồi thực
balat	balat
antinhtheloi	ân tình thế lợi
boctroi	bốc trời
boihoan	bội hoàn
antinh	ân tình
batmohoidoibatcom	bát mồ hôi đổi bát cơm
bachphan	bách phân
bongthuytinh	bông thuỷ tinh
anngonmacdep	ăn ngon mặc đẹp
binhkhang	bình khang
bovixuli	bộ vi xử lí
bochieu	bó chiếu
beng	beng
bacthuy	Bắc Thuỷ
bonta	bọn ta
banhda	bánh đa
bienthan	biến thân
anbocdaidung	ăn bốc đái đứng
binhbien	binh biến
ansungtrangai	ăn sung trả ngái
amhieu	âm hiệu
anban	ăn bận
bachtuyet	bạch tuyết
bolo	bô lô
aovet	áo vét
bon-ne	bon-nê
biendich	biến dịch
auda	ẩu đả
ankilamdoi	ăn kĩ làm dối
binhmoiruoucu	bình mới rượu cũ
apdao	áp đảo
bongtien	bồng tiên
bonghuynh	bóng huỳnh
beque	bẻ quế
bacdau	Bắc Đẩu
baotrum	bao trùm
baolathiendia	bao la thiên địa
ac-cooc	ắc-coóc
benchacungkinhbenmecungvai	bên cha cũng kính, bên mẹ cũng vái
binhdiaphongba	bình địa phong ba
biudai	bìu dái
bobuoc	bó buộc
bangay	bàn gảy
biendinh	biên đình
bamuoitet	ba mươi Tết
bangla	Bàng La
bansondia	bán sơn địa
anhkim	ánh kim
ansau	ăn sâu
bangthach	băng thạch
bom-be	bom-bê
banghuyet	băng huyết
banui	bàn ủi
aoso-mi	áo sơ-mi
auyem	âu yếm
batlythan	bất ly thân
aoao	ào ào
bichson	Bích Sơn
baquyettam	ba quyết tâm
batmieng	bắt miếng
bansom	ban sớm
bonglai	Bồng Lai
amiu	ẩm ỉu
acidnitric	acid nitric
boiphuc	bội phục
bo-lang-tong	bờ-lăng-tông
batri	Ba Tri
baocao-su	bao cao-su
beou	béo ụ
benhkinhnien	bệnh kinh niên
anmanh	ăn mánh
ansanh	ăn sành
banam	Ba Nam
anchaolada	ăn cháo lá đa
binhvan	binh vận
beonuc	béo núc
banhhoi	bánh hơi
binhtrung	Bình Trung
anxoiothi	ăn xổi ở thì
anxai	ăn xài
baonuoc	bão nước
binhchieu	Bình Chiểu
bepga	bếp ga
bopmeo	bóp méo
aian	ái ân
bongkhe	Bồng Khê
bapbenh	bấp bênh
anconoichoicochon	ăn có nơi, chơi có chốn
boma	bom a
boithungansach	bội thu ngân sách
bangtuyet	băng tuyết
anduachuarau	ăn dưa chừa rau
baochuong	báo chương
boiech	bơi ếch
akim	á kim
annhontay	An Nhơn Tây
bacmyan	Bắc Mỹ An
am-pun	ăm-pun
bientro	biến trở
beurech	bệu rệch
basoihailanh	ba sôi hai lạnh
adong	á đông
anthan	an thần
boimau	bối mẫu
anmayannhat	ăn mày ăn nhặt
aobaba	áo bà ba
bietvoamtin	biệt vô âm tín
bachchunien	bách chu niên
bonphuongtroimuoiphuongphat	bốn phương trời, mười phương phật
binhsa	bình sa
autri	ấu trĩ
banmay	bàn máy
bietbaomake	biết bao mà kể
bihiem	bí hiểm
binhtam	Bình Tâm
banhxethunam	bánh xe thứ năm
atuc	A Túc
adu	a du
boingua	bơi ngửa
anhach	anh ách
bochehoakhi	bộ chế hoà khí
bican	bị can
bantoibanlui	bàn tới bàn lui
aonamthan	áo năm thân
an-to	an-tô
amem	ấm êm
anhhungcanhan	anh hùng cá nhân
banbao	bản báo
binhnham	Bình Nhâm
autrang	âu trang
auxi	ẩu xị
batgan	bắt gân
biettieng	biết tiếng
bencanh	bên cạnh
bongtoi	bóng tối
anhhungrom	anh hùng rơm
bietcu	biệt cư
battieu	bất tiếu
batkhoan	bắt khoán
baodai	Bảo Đại
bachdau	bạch đậu
am-pli	am-pli
ailuchoahoc	ái lực hoá học
bieudien	biểu diễn
aithan	ái thần
batthiep	bạt thiệp
boluy	bờ luỹ
bathieubatmuc	bất hiếu bất mục
amib	amib
ancaybungtai	ăn cáy bưng tai
a-dot	a-dốt
boong	boong
beainguoiaychong	bè ai người ấy chống
bienlieu	biện liệu
anthit	ăn thịt
bachhoa	bách hoa
bemeo	bẹ mèo
binhdiabadao	bình địa ba đào
bay	bầy
baudoan	bầu đoàn
bienam	biến âm
bongda	bông đá
anhhoa	anh hoa
baomombaomieng	bạo mồm bạo miệng
aipha	ải phà
bamieng	bã miệng
bongbong	bòng bong
bitmatbatde	bịt mắt bắt dê
baptay	bắp tay
amap	ăm ắp
antinh	an tĩnh
bietdau	biết đâu
bonbinh	bồn binh
banhquay	bánh quẩy
biendong	Biển Động
aoaonhuongvoto	ào ào như ong vỡ tổ
batminh	bất minh
biec	biếc
ayunpa	Ayun Pa
binhhuong	bình hương
banquoc	bản quốc
ainhiem	ái nhiễm
anthang	An Thắng
bannhuchokhong	bán như cho không
anboi	An Bồi
anchua	ẩn chứa
bancunhatphuong	bàn cứ nhất phương
batthong	bất thông
baytoi	bầy tôi
andat	an dật
andauonho	ăn đậu ở nhờ
ancapannay	ăn cắp ăn nảy
binhhangtay	Bình Hàng Tây
bachdai	bạch đái
boncua	bòn của
benlong	bên lòng
aulo	âu lo
biu	bìu
aotuong	ảo tưởng
bachthuoc	bạch thược
anhhunghaokiet	anh hùng hào kiệt
bochoi	bốc hơi
anchaodegaochovay	ăn cháo để gạo cho vay
bienchung	biện chứng
bonao	bộ não
boimep	bôi mép
botulenh	bộ tư lệnh
bienloan	biến loạn
banhquy	bánh quy
baoon	báo ơn
anthatlamdoi	ăn thật làm dối
bachnhanbachtinh	bách nhân bách tính
an-tora-xit	an-tÒra-xít
bonetcogiecui	bọ nẹt có giẻ cùi
binhlinh	binh lính
antinh	ân Tình
boduong	bố dượng
alu	A Lù
banxon	bán xon
binhtan	Bình Tân
ansongansit	ăn sống ăn sít
battacvi	bất tác vi
ankhong	ăn không
bacao	bá cáo
anco	ăn cỗ
booc-te	boóc-tê
anhang	ăn hàng
a-gon	a-gon
baophuc	báo phục
angcang	ẳng Cang
bongbay	bóng bay
anh-te-ruyp-to	anh-te-ruýp-tơ
bolao	bố láo
anle	An Lễ
beonhuconvam	béo như con vâm
bosua	bơ sữa
batkhatriluan	bất khả tri luận
bangtin	bẵng tin
boinho	bôi nhọ
balangan	Ba Làng An
aoluaquanhong	áo lụa quần hồng
apsuatkhongkhi	áp suất không khí
banrao	bán rao
binhluan	bình luận
amnhachoc	âm nhạc học
bienniensu	biên niên sử
bayviabahon	bảy vía ba hồn
angiaybobia	ăn giấy bỏ bìa
bacnhuoc	bạc nhược
bangtreo	băng treo
amdau	âm đầu
anthanthuphan	an thân thủ phận
apsuat	áp suất
battoibatva	bắt tội bắt vạ
bachtrietthienma	bách triết thiên ma
boiphan	bội phản
anhhunglaodong	anh hùng lao động
baybien	bay biến
baohiembatbuoc	bảo hiểm bắt buộc
bonphang	Bon Phặng
bacdai	bạc đãi
binhquoi	Bình Quới
amluat	âm luật
binhtuoi	bình tưới
banbuitredebuihop	bắn bụi tre, đè bụi hóp
banrong	bán rong
baongu	bào ngư
a-la-han	A-la-hán
acdao	ác đạo
belai	bẻ lái
binhdien	bình diện
baiboi	bãi bồi
benguoidoichoitreo	bé người đòi chơi trèo
acchien	ác chiến
aoluotquanla	áo lượt quần là
baroi	ba rọi
bangvideo	băng video
bich-qui	bích-qui
bantay	bàn tay
biettay	biết tay
binhnghia	Bình Nghĩa
anhiep	An Hiệp
aikhi	ái khí
bayvai	bày vai
bitum	bitum
annhoodau	ăn nhờ ở đậu
automat	automat
boonnhiet	bộ ổn nhiệt
bau	bầu
balem	ba lém
aobo	áo bó
banthietke	bản thiết kế
batdinh	bắt đinh
bacbackieuki	bắc bậc kiêu kì
biettai	biệt tài
bachdaukhau	bạch đậu khấu
boirua	bói rùa
bana	Ba Na
boclua	bốc lửa
beomep	bẻo mép
anco	ăn cỏ
bientich	biên tịch
bietdien	biệt điện
beotrucbeotron	béo trục béo tròn
ande	ăn dè
ancungmamnamcungchieu	ăn cùng mâm, nằm cùng chiếu
banhbeo	bánh bèo
bilattay	bị lật tẩy
an-te	an-te
benredamchoi	bén rễ đâm chồi
anlen	ăn lén
banmanh	bán manh
anlayande	ăn lấy ăn để
banxoay	bàn xoay
botxuyen	Bột Xuyên
bobay	bộ bảy
bachtuoc	bạch tuộc
angian	ăn gian
bauveo	bấu véo
amaamo	ấm a ấm ớ
battien	bát tiên
boxoiruongmat	bờ xôi ruộng mật
boion	bội ơn
bayluon	bay lượn
baysap	bẫy sập
beomaytanhop	bèo mây tan hợp
bienphong	biên phòng
boc-xo	bốc-xơ
bangkinh	băng kinh
binhtrinhdong	Bình Trinh Đông
batcau	bắt câu
betrong	bề trong
anloc	ăn lộc
banhumbuonsoi	bán hùm buôn sói
amoe	ấm óe
bachvi	bạch vi
batine	batinê
baison	Bài Sơn
bongbong	bong bóng
annhuhumdodo	ăn như hùm đổ đó
anquenbenmui	ăn quen bén mùi
anchatdedanh	ăn chắt để dành
binhtuy	Bình Tuy
batquan	bất quản
anmonkimloai	ăn mòn kim loại
andauanduoi	ăn đầu ăn đuôi
ap-phe	áp-phe
bathieu	bất hiếu
boloi	bỏ lỗi
anitngonnhieu	ăn ít ngon nhiều
anhoa	ân Hoà
bannguyen	Bản Nguyên
amvang	âm vang
bannatra	bàn nát ra
bothuoc	bỏ thuốc
bomoibatbong	bỏ mồi bắt bóng
antucnoiphet	ăn tục nói phét
boituong	bói tuồng
bongtieu	bông tiêu
bondai	bòn đãi
boiduong	bồi dưỡng
beta	beta
anbao	ăn báo
bandau	ban đầu
anhnhi	anh nhi
aiomimieugi	ái ố mĩ miều gì
bienchu	biên chú
baogom	bao gồm
bienlang	biển lặng
bamausaucon	ba máu sáu cơn
biencam	biến cảm
bamuoitet	ba mươi tết
aogiac	ảo giác
basinhhuonglua	ba sinh hương lửa
antucnoikhoac	ăn tục nói khoác
bocroi	bốc rời
bonnhuthocongbonvang	bòn như thổ công bòn vàng
apdien	áp điện
bi-da	bi-da
banvodocon	bán vợ đợ con
aphudung	ả phù dung
andamnamde	ăn dầm nằm dề
aosautotca	ao sâu tốt cá
bem	bem
bonba	bôn ba
binhhoadong	Bình Hoà Đông
banso	ban sơ
aogiaprom	áo giáp rơm
bachxa	Bạch Xa
baokhe	Bảo Khê
bonphuongtamhuong	bốn phương tám hướng
anchom	ăn chõm
banggia	bang gia
bangtruong	bang trưởng
ankhach	ăn khách
bachlong	Bạch Long
baytre	bầy trẻ
batrexauchuoi	bắt rễ xâu chuỗi
bongnaotrongay	bồng nào trống ấy
anthe	ăn thề
binhcongchamdiem	bình công chấm điểm
barie	barie
an-ten	an-ten
amdieu	âm điệu
apiu	ấp iu
a-ni-on	a-ni-ôn
bachluu	Bạch Lưu
anro	ăn rơ
banmomnuoimieng	bán mồm nuôi miệng
boiloi	bơi lội
banmuutinhchuoc	bàn mưu tính chước
baibinh	bại binh
baito	bái tổ
ammuu	âm mưu
bepmattroi	bếp mặt trời
bietchung	biết chừng
bothuoc	bộ thuộc
ba-dan	ba-dan
binhthongnhau	bình thông nhau
boxuyen	Bồ Xuyên
bobobombom	bo bo bỏm bỏm
bientiet	biến tiết
bich-quy	bích-quy
bangnang	băng nâng
bientuong	biến tướng
ao	ào
biet	Biêt
bangisat	ban gỉ sắt
bachhuyet	bạch huyết
beconchach	be con chạch
bobin	bôbin
bon-se-vichhoa	bôn-sê-vích hóa
baotapmuasa	bão táp mưa sa
ac-mo-ni-ca	ác-mô-ni-ca
baimien	bãi miễn
bahoaxichde	ba hoa xích đế
baiyet	bái yết
bantenkhongdich	bắn tên không đích
biengchoi	biếng chơi
binh	binh
anloat	ấn loát
bonxu	bôn xu
bangchung	băng chừng
aulac	âu Lạc
ba-do	ba-dơ
binhtinh	binh tình
anhdanh	anh danh
an-to-ra-xit	an-tơ-ra-xít
baogio	bao giờ
bohoang	bỏ hoang
bidon	bị đơn
baymui	bay mùi
bavuong	bá vương
baibai	bái bái
bodao	bồ đào
benhbe	bênh bè
annhuhophapcantrat	ăn như hộ pháp cắn trắt
bogiang	Bố Giang
angiau	ẩn giấu
aptai	áp tải
bankinhsatthuong	bán kính sát thương
banthoatli	bán thoát li
aida	ai dà
behe	bè he
bichqui	bích qui
benganquyetchi	bền gan quyết chí
ba-ke-lit	ba-ke-lít
biensoan	biên soạn
biennien	biên niên
anhhungkhongdatdungvo	anh hùng không đất dụng võ
bavi	Ba Vì
anquy	An Quý
bienchungphapduyvat	biện chứng pháp duy vật
bomuoivaomat	bỏ muối vào mặt
bongan	Bồng An
bachduong	bạch dương
baotapphongba	bão táp phong ba
banhphuclinh	bánh phục linh
baibinh	bãi binh
annam	ăn nằm
baothuc	báo thức
ai	ai
bangnhu	bằng như
bangvangbiada	bảng vàng bia đá
beomep	béo mép
bietthop	biết thóp
bapsu	bắp su
bencau	Bến Cầu
badaybaykhe	ba dãy bảy khê
anhoatay	An Hoà Tây
bongbang	bông băng
bangca	băng ca
bombay	bom bay
baico	bãi cỏ
binhson	bình sơn
ban	ban
baicho	bãi chợ
aobuongchungquandonggot	áo buông chùng, quần đóng gót
bibeng	bí beng
baodan	bạo dạn
banggiao	bang giao
bomuoi	Bó Mười
aocasa	áo cà sa
andeo	ăn đẽo
basao	Ba Sao
boitin	bội tín
babayhammotngay	ba bảy hăm mốt ngày
annhutamanroi	ăn như tằm ăn rỗi
binhthuyen	binh thuyền
anlu	An Lư
anhtrai	anh trai
anden	ăn đèn
binhroitramgay	bình rơi trâm gãy
boinhiem	bội nhiễm
anvien	An Viễn
bachquan	bách quan
bangxuongbangthit	bằng xương bằng thịt
baocua	bạo cửa
anphu	An Phụ
baymuoi	bảy mươi
banan	ban ân
bitruyen	bí truyền
binhvoi	bình vôi
benmat	bên mặt
amuong	ẩm ương
boludong	bờ lu dông
bentroigocbe	bên trời góc bể
biettin	biệt tin
bao	bao
amthoa	âm thoa
ac-e	ắc-ê
bachkhoatudien	bách khoa từ điển
baicao	bài cào
binhthuan	Bình Thuận
balasat	bà la sát
bietdauday	biết đâu đấy
betramluan	bể trầm luân
amian	amian
benngoai	bên ngoài
anquancoixay	ăn quẩn cối xay
bacruong	Bắc Ruộng
andungngoiroi	ăn dưng ngồi rồi
baibang	bài báng
bichthuy	bích thuỷ
baomenh	bảo mệnh
annhunam-havacdat	ăn như Nam-hạ vác đất
bansungchangnenphaidendan	bắn súng chẳng nên phải đền đạn
baotuthe	bào tử thể
baichientruong	bãi chiến trường
auom	à uôm
batbongbatgio	bắt bóng bắt gió
bantoimaytoimat	bận tối mày tối mặt
binhboong	bính boong
banvien	bán viên
anbonanmot	ăn bòn ăn mót
baoxoiuxoibaothituthit	bảo xôi ừ xôi, bảo thịt ừ thịt
ankeodau	ăn ké ở đậu
banvongnien	bạn vong niên
baomatphonggian	bảo mật phòng gian
beobong	bèo bồng
anda	an dạ
a-xitduong	a-xít đường
boitich	bồi tích
bovophaidam	bố vợ phải đấm
amnhan	âm nhấn
botmen	bột men
bensong	bến sông
benhtetuyen	bệnh Tề Tuyên
boan	bỏ ăn
bankhongkipmomat	bận không kịp mở mắt
bangdanhdu	bảng danh dự
banhdauxanh	bánh đậu xanh
aogamdaivang	áo gấm đai vàng
baomang	bảo mạng
baithom	Bãi Thơm
bathoa	bất hoà
bieulo	biểu lộ
baomua	bao mua
begiang	bế giảng
baora	bào rà
anquyet	án quyết
bacthang	bắc thang
bantrieu	bản triều
baohiemhonhop	bảo hiểm hỗn hợp
asean	ASEAN
biendoi	biến đổi
bo-mam	Bơ-mấm
batphuongtrinh	bất phương trình
bandem	ban đêm
amaamach	ấm a ấm ách
anchen	ăn chẹn
ang-ten	ăng-ten
bamgannatruot	bầm gan nát ruột
aodaichongaiquanthua	áo dài chớ ngại quần thưa
antaiantam	ăn tái ăn tam
binhphi	binh phí
bancualuoitrang	ban cua lưỡí trắng
angian	án gian
bocau	bồ câu
bentrongbenkhinh	bên trọng bên khinh
biumoibiumo	bĩu môi bĩu mỏ
batloi	bất lợi
aorachquanmanh	áo rách quần manh
banhbonglan	bánh bông lan
baolinh	bảo lĩnh
bentrong	bên trong
anhchi	anh chị
amnhiet	ẩm nhiệt
bancong	ban công
batgioi	bát giới
bachniengiailao	bách niên giai lão
bavobavat	bá vơ bá vất
baymuudatke	bày mưu đặt kế
baonhai	Bảo Nhai
anvochochay	ăn vóc học hay
anthu	án thư
bietdauchung	biết đâu chừng
bienminh	biện minh
balon	ba lơn
bannhuhui	bẩn như hủi
bantrang	ban trắng
bangtay	băng tay
batxampham	bất xâm phạm
bokhihuyet	bổ khí huyết
battai	bất tài
angiac	an giấc
bayve	bày vẽ
anhem	anh em
banvekithuat	bản vẽ kĩ thuật
bachtheluuphuong	bách thế lưu phương
apungnhungamhotthi	ấp úng như ngậm hột thị
banvinhcuu	bán vĩnh cửu
beurieu	bêu riếu
anuu	ân ưu
beou	béo ú
binhthanh	Bình Thanh
ancomhot	ăn cơm hớt
batgiong	bắt giọng
biudiu	bìu díu
anuy	an uỷ
becao	bề cao
baivong	bái vọng
anbongcaytung	ẩn bóng cây tùng
beubao	bệu bạo
bimson	Bỉm Sơn
bonba	bôn bá
anro	ăn rở
annhuthantrung	ăn như thần trùng
banhuu	bản hữu
bantheluan	bản thể luận
aitien	ái tiền
binhthanphucvi	bình thân phục vị
baobenh	bạo bệnh
anxomonieu	ăn xó mó niêu
batnhao	bát nháo
anha	An Hà
bahoi	bã hơi
aokhoac	áo khoác
bauham	bầu hâm
baunam	bầu nậm
biadat	bịa đặt
anvinh	An Vinh
bolihop	bộ li hợp
bomoi	bỏ mối
biettich	biệt tích
annhat	ăn nhặt
baohinh	bao hình
anbuasanglanbuatoi	ăn bữa sáng, lần bữa tối
baxoa	bã xõa
biettambiettich	biệt tăm biệt tích
anhai	ăn hại
bonam	bộ năm
boinghia	bội nghĩa
botbien	bọt biển
babua	ba búa
bancong	Ban Công
bonao	bổ não
boleboquang	bò lê bò quàng
a-xe-ton	a-xê-ton
antho	An Thọ
bopho	bơ phờ
bere	bê rê
baotrong	bảo trọng
antudaudandencuoidau	ăn từ đầu dần đến cuối dậu
bibo	bí bơ
boilap	bồi lấp
bandao	bàn đào
batlienlac	bắt liên lạc
bongtrang	bóng trăng
baudoanthetu	bầu đoàn thê tử
botongtulenh	bộ tổng tư lệnh
auhan	âu hẳn
binhdan	Bình Dân
binhphan	Bình Phan
batdien	bát diện
aotuong	ảo tượng
bauban	bầu bán
ahau	á hậu
banquatmuadongbanbongmuahe	bán quạt mùa đông, bán bông mùa hè
baba	ba ba
andanh	ẩn danh
anquan	ấn quán
baosinh	bảo sinh
ancoditruocloinuoctheosau	ăn cỗ đi trước, lội nước theo sau
amdong	Am Đồng
binhgioi	binh giới
aquan	á quân
bagia	bà già
beohoadau	bèo hoa dâu
baoboc	bao bọc
boichung	bội chung
benhnghenghiep	bệnh nghề nghiệp
aocanh	áo cánh
batdaison	Bát Đại Sơn
bale	balê
boingoi	bòi ngòi
ba-lat	ba-lát
baohomaudich	bảo hộ mậu dịch
baoluc	bạo lực
anbai	An Bài
aichacha	ái chà chà
bilau	bỉ lậu
biengiai	biện giải
babo	bà bô
bethuyen	be thuyền
andien	ân điển
behattieu	bé hạt tiêu
badaloc	Bá Đa Lộc
an	ân
bavai	bả vai
batviakinhhon	bạt vía kinh hồn
aodoquandieu	áo đỏ quần điều
batra	ba trá
bacvituyen	bắc vĩ tuyến
bietdang	biệt dạng
bongtrang	Bông Trang
anthanhnoilich	ăn thanh nói lịch
anphan	ăn phân
bida	bi da
bengiongquenhoi	bén giọng quen hơi
ancu	an cư
batvoamtin	bặt vô âm tín
anxuachuanay	ăn xưa, chừa nay
anocnoimo	ăn ốc nói mò
bannghia	bản nghĩa
aoomkhorach	áo ôm khố rách
baychuot	bẫy chuột
bienhoathanthong	biến hoá thần thông
bietviec	biết việc
batieu	ba tiêu
anduong	An Dương
bongvu	bong vụ
bando	ban đỏ
bilao	bí lào
ben-zen	ben-zen
baucan	Bàu Cạn
bobao	bổ báo
bongnguyet	bóng nguyệt
bennguyen	bên nguyên
batqua	bất quá
biky	bi ký
ba-hi	Ba-hi
bacotlendong	bà cốt lên đồng
apdoimoi	ấp đời mới
anhuyet	án huyệt
beoquay	béo quay
binhdaokhoilua	binh đao khói lửa
baoan	báo an
batcai	bắt cái
bangchan	bằng chân
annhau	ăn nhậu
apdieu	áp điệu
baothap	bảo tháp
ac-cooc	ác-coóc
andut	ăn đứt
bohu	bổ hư
bankhoang	Bản Khoang
bongloang	bóng loáng
banbithu	ban bí thư
bienphuong	biên phương
bodoi	bộ đội
acnhan	ác nhân
bongdau	bóng dâu
actang	ác tăng
ay	áy
boma	bom A
binhhoa	binh hoả
bacmay	bạc mày
bacso	Bắc Sơ
biemhoa	biếm hoạ
boike	bội kế
aorachvangiulaytrang	áo rách vẫn giữ lấy tràng
baochung	bảo chứng
binhdia	bình địa
bay	bay
bachkim	bách kim
battrang	Bát Trang
bocnhieu	Bộc Nhiêu
beoxu	béo xù
bieutinh	biểu tình
bannguyen	bản nguyên
bienthengonngu	biến thể ngôn ngữ
ac-ten	ác-ten
anhhungchunghia	anh hùng chủ nghĩa
amhao	âm hao
bangtich	băng tích
bangluonggiac	bảng lượng giác
besau	bề sâu
bonggio	bóng gió
baocao	báo cáo
bangrung	băng rung
ancuop	ăn cướp
amnhietke	ẩm nhiệt kế
amhieu	am hiểu
bo-xit	bô-xít
anguy	a nguỵ
anganuongmau	ăn gan uống máu
aulau	âu Lâu
babop	ba bớp
baohieu	Bảo Hiệu
banquang	bẩn quặng
bachcuongtam	bạch cương tàm
bachondoinoi	ba chốn đôi nơi
bobunsangao	bỏ bùn sang ao
bancamuithuyen	bán cá mũi thuyền
bapbenh	bập bênh
baungung	bầu ngưng
banlien	Bản Liền
beudau	bêu đầu
ammay	am mây
antuong	ân Tường
banon	ban ơn
anduc	An Đức
baochinh	bạo chính
bocuu	bổ cứu
bovia	bở vía
barem	ba rem
banthuongbanha	bán thượng bán hạ
ancuoi	ăn cưới
anduc	ân đức
baonai	bao nài
adi	A Di
bebangconkien	bé bằng con kiến
annogiamchuong	ăn no giậm chuồng
anham	ảnh âm
bieudo	biểu đồ
anda	ăn da
banduong	bạn đường
banbe	ban bệ
baocovien	bảo cô viện
a-ni-lin	a-ni-lin
banthang	bàn thang
bonbienmotnha	bốn biển một nhà
bailay	bãi lầy
be	bê
boihoat	bội hoạt
baclong	bạc lông
baohuynh	bào huynh
binhchuong	Bình Chương
beomam	béo mẫm
ancomthienha	ăn cơm thiên hạ
adhoc	ad hoc
bocmui	bốc mùi
ansesedeconvoi	ăn se sẻ đẻ con voi
ancomnhathoituvahangtong	ăn cơm nhà, thổi tù và hàng tổng
annhugauantrang	ăn như gấu ăn trăng
anthanh	An Thành
bongtrang	bông trang
banchong	bàn chông
baochay	bao chầy
benhtuong	bệnh Tưởng
bitmatthegian	bịt mắt thế gian
aoaocho	ào ào chó
ancam	ăn cám
bayluoi	bẫy lưới
aphien	a phiến
anchan	An Chấn
binhanvosu	bình an vô sự
baono	bao nỡ
baquan	bá quan
bamque	bấm quẻ
baynoibachim	bảy nổi ba chìm
bocuve	bồ cu vẽ
baybuom	bay bướm
bachdien	bạch điến
binhhien	Bình Hiên
achai	ác hại
batcan	bất can
aoao	ao ảo
amluong	âm lượng
bohoa	bỏ hoá
bacphong	Bắc Phong
bia	bia
anvuongbovai	ăn vương bỏ vãi
bitmiengbungtai	bịt miệng bưng tai
anchangnendoinoichangnenloi	ăn chẳng nên đọi, nói chẳng nên lời
bietgiao	biệt giao
beotamtia	bèo tấm tía
binhluong	binh lương
ancocophan	ăn cỗ có phần
aunoi	âu nổi
baithai	bãi thải
badon	Ba Đồn
aimuon	ai mượn
biachai	bia chai
a-xit	a-xit
biendo	biên độ
bamen	bạ men
anchaynammong	ăn chay nằm mộng
beomup	béo múp
bonhuvoi	bở như vôi
aolienruongca	ao liền ruộng cả
bepnuoc	bếp nước
bong	bong
anlot	ăn lót
bocbaidansang	bốc bải dần sàng
battham	bắt thăm
an-de-hit	an-đe-hít
banhuyet	bần huyết
bomhatnhan	bom hạt nhân
bancap	ban cấp
bachoa	Bắc Hoà
binhxuyen	Bình Xuyên
bonnoikhobendainoiquanhong	bòn nơi khố bện đãi nơi quần hồng
audanh	âu đành
bosua	bò sữa
baomat	bảo mật
aihoai	ai hoài
biet	biết
boicheo	bơi chèo
bothammuu	bộ tham mưu
axetilen	axetilen
aochet	áo chẹt
basinh	ba sinh
banchan	bàn chân
bobo	bo bo
aythema	ấy thế mà
anne	ăn nể
bamsinh	bẩm sinh
baukhongkhi	bầu không khí
boinhap	bội nhập
bode	bôđê
batquatambaban	bất quá tam ba bận
apchienluoc	ấp chiến lược
baynhieu	bấy nhiêu
bachbien	bạch biến
anthungtradau	ăn thúng trả đấu
biudiu	bíu díu
binhdodocao	bình đồ độ cao
anconhainoiconghi	ăn có nhai, nói có nghĩ
baygio	bây giờ
bapchuoi	bắp chuối
batchim	bắt chim
annhau	ăn nhau
bokhopa	Bồ Khô Pạ
badau	bã dầu
ancomnguoinamnhangoai	ăn cơm nguội, nằm nhà ngoài
banbia	bắn bia
bienthuy	biên thùy
antuong	ẩn tướng
bomua	bỏ mứa
acquy	ác quỷ
bongbauduc	bóng bầu dục
bottan	bột tan
aodaikhanxep	áo dài khăn xếp
bayba	bây bả
bamhuyet	bấm huyệt
binhluoc	binh lược
aophao	áo phao
aochoang	áo choàng
aoam	áo ấm
au	ẩu
bengoi	Bến Gối
anhhai	anh hai
bienthuy	biên thuỳ
batchuyen	bất chuyển
amnhac	âm nhạc
beoong	bèo ong
baugiac	bầu giác
bathoagiai	bất hòa giải
bangan	bằng an
bancai	Bản Cái
bamgio	bấm giờ
baitulong	Bái Tử Long
boibo	bồi bổ
bienmang	biện mang
anbinhb	An Bình B
bonbon	bòn bon
bogiaima	bộ giải mã
anchiu	ăn chịu
aphuyet	áp huyết
baihoc	bài học
baccua	bậc cửa
amtrinh	âm trình
anbuanaylobuamai	ăn bữa nay, lo bữa mai
bieumau	biểu mẫu
beophi	béo phì
biquan	bí quẫn
a-pac-thai	a-pác-thai
becanhcungque	bẻ cành cung quế
baivatgiao	bái vật giáo
bathungcungvaomotdau	ba thúng cũng vào một đấu
bia	bìa
batdenxanh	bật đèn xanh
anlac	an lạc
banxuathuyet	ban xuất huyết
batvan	bát văn
bauchu	bầu chủ
beophucphich	béo phục phịch
binhlieu	Bình Liêu
anhca	anh cả
biki	bi kí
benhnhan	bệnh nhân
auo	ầu ơ
bandonhiphe	bán đồ nhi phế
bocloi	bộc lôi
bochetchangkhoirom	bò chết chẳng khỏi rơm
baccau	bắc cầu
banhkeo	bánh kẹo
anhdung	anh dũng
bacumbac	Ba Cụm Bắc
bokhuyet	bổ khuyết
baylieng	bay liệng
baoan	báo ân
beainaychong	bè ai nấy chống
amsinh	ấm sinh
anhtuan	anh tuấn
binhluc	binh lực
bangtra	bảng tra
andan	an dân
amho	âm hộ
aoat	ào ạt
banhtro	bánh tro
benhthoikhi	bệnh thời khí
bang	băng
anduocnoinen	ăn được nói nên
annguoi	ăn nguội
babomotgia	ba bó một giạ
batchietyeu	bát chiết yêu
bandumuc	bán du mục
anlao	An Lão
belangsongyen	bể lặng sóng yên
bentre	Bến Tre
amkhu	âm khu
baotho	bảo thọ
biu	bịu
batlitrithu	bất li tri thù
beubeu	bều bệu
banhquaivac	bánh quai vạc
batcomphieumau	bát cơm phiếu mẫu
ampho	âm phổ
bantienmacvong	bần tiện mạc vong
balo	ba lô
babua	ba bửa
anngauannghien	ăn ngấu ăn nghiến
aula	âu là
anthan	ẩn thân
aobo-lu	áo bờ-lu
baodai	bao dai
banngay	ban ngày
bedoi	bè đôi
bongbabongbenh	bống ba bống bếnh
bagia	bà gia
bacbangduong	Bắc băng dương
andaynoido	ăn đây nói đó
bodieugiai	bộ điều giải
aokhi	áo khỉ
baothanh	Bảo Thanh
borua	bọ rùa
andien	An Điền
bacphang	bắc phang
amvihoc	âm vị học
an-pha-be	an-pha-bê
baxuyen	Bá Xuyên
ainu	ái nữ
boidap	bồi đắp
baisay	Bãi Sậy
bachmi	bạch mi
boian	bội ân
any	ăn ý
aovet-tong	áo vét-tông
bao	bão
bantroikhongvantu	bán trời không văn tự
bavo	bá vơ
acnghiepcocau	ác nghiệp cơ cầu
binhco	binh cơ
batnhuoc	bất nhược
bosia	bổ sịa
bangcuuchuong	bảng cửu chương
bachhoatonghop	bách hoá tổng hợp
babebayboi	ba bè bảy bối
baithangiao	bái thần giáo
banhhoi	bánh hỏi
benhvien	bệnh viện
bongcai	bông cải
binhnghi	Bình Nghi
anbinh	An Bình
annhoocay	ăn nhờ ở cậy
binhyen	bình yên
aicha	ái chà
acdieu	ác điểu
bephoangcam	bếp Hoàng Cầm
bachgiachutu	bách gia chư tử
antiec	ăn tiệc
an	an
bengang	bề ngang
anban	ân ban
ai	ái
boong-ke	boong-ke
anluong	ăn lường
bietle	biệt lệ
ansungngoigoccaysung	ăn sung ngồi gốc cây sung
baochu	bảo chủ
bathan	bà thân
bonsevich	bon sê vích
am-pe	am-pe
balao	bà lão
aocanh	ảo cảnh
anvay	ăn vay
bo-de	bô-đê
boncanh	bôn cạnh
baophong	bào phòng
biem	biếm
baonho	bảo nhỏ
bida	bida
batmechieumanh	bát mẻ chiếu manh
baquyen	bá quyền
bienchung	biến chứng
bobien	bờ biển
bannguyetsan	bán nguyệt san
beovan	bèo ván
bachkhoathutonghop	bách khoa thư tổng hợp
baihoaibaihoai	bải hoải bài hoài
bao	bảo
bandan	bần dân
aomacquadau	áo mặc qua đầu
bienuyvien	biên uỷ viên
bao	báo
batmoi	bắt mối
botxoa	bột xoa
aothuat	ảo thuật
banhtrai	bánh trái
aolanh	áo lạnh
at-phan	át-phan
angia	ăn giá
aochuom	ao chuôm
anon	an ổn
bitho	bí thơ
bikhuc	bi khúc
baychu	bây chừ
baoson	Bảo Sơn
baychong	bẫy chông
bangdiem	băng điểm
amoe	ậm oẹ
amsieu	ấm siêu
banloan	bấn loạn
boicau	Bối Cầu
baihoai	bại hoại
bendoisongcho	bến đợi sông chờ
anthuan	An Thuận
boluat	bộ luật
bailo	bại lộ
anbien	An Biên
aogaigiayco	áo gai giày cỏ
bangbang	bâng bâng
amhoc	âm học
benhxahoi	bệnh xã hội
bongnuoc	bóng nước
beubeu	bêu bêu
anthuatu	ăn thừa tự
bienho	biện hộ
an-ca-lo-it	an-ca-lô-ít
bansang	ban sáng
bahoachichchoe	ba hoa chích chòe
banhchung	bánh chưng
bachuaphaigai	bà chúa phải gai
ando	ăn dỗ
anphutrung	An Phú Trung
bacoongmanh	bà cô ông mãnh
anhai	An Hải
bonai	bò nái
batvia	bạt vía
bachchienbachthang	bách chiến bách thắng
baotho	bao thơ
binhvan	Bình Văn
aoken	áo kén
amam	âm âm
atidianguc	A Tì địa ngục
balai	Ba Lai
binhthan	Bình Than
benhoi	bén hơi
barie	ba ri e
baoluu	bảo lưu
bodi	bỏ đi
baky	Ba Kỳ
banbau	bạn bầu
batui	ba tui
banlua	bạn lứa
bobua	bỏ bùa
an-bom	an-bom
bachchien	bách chiến
bolydau	bộ ly dầu
baco	bà cô
acon	ác ôn
banghuu	bằng hữu
ba-do-xuy	ba-đờ-xuy
bothanam	bổ thận âm
boduong	bổ dưỡng
baudieu	bầu diều
baobinh	bạo binh
bechangvincagaycanh	bé chẳng vin, cả gẫy cành
bandoan	bán đoạn
baimin	bãi mìn
bienthetungau	biến thế tự ngẫu
bosiet	bo siết
banmuutinhke	bàn mưu tính kế
bobao	bô báo
anhdung	Anh Dũng
boiroitovo	bối rối tơ vò
bogiau	bờ giậu
boithe	bội thề
baichau	bãi chầu
bengbeng	beng beng
antrung	An Trung
bocgioi	bốc giời
annhumokhoet	ăn như mỏ khoét
angiabua	ăn giả bữa
batxau	bắt xâu
bonguachongxe	bọ ngựa chống xe
bongcoganbongbopcoganbop	bống có gan bống, bớp có gan bớp
anboong	ăn boóng
ansi	ăn sỉ
bocoi	bờ cõi
ahanhactoi	a hành ác tỏi
ai	ải
banhram	bánh ram
badau	ba đậu
anchaodaibat	ăn cháo đái bát
achyeu	ách yếu
anthitnguoikhongbiettanh	ăn thịt người không biết tanh
boday	bố đay
bancai	bàn cãi
bolanboloc	bò lăn bò lóc
banhgiay	bánh giầy
boithuongchientranh	bồi thường chiến tranh
batchau	bát chậu
anngonnguki	ăn ngon ngủ kĩ
anthanh	An Thanh
bavanchinnghin	ba vạn chín nghìn
amthuytunguyen	ẩm thuỷ tư nguyên
anthoidong	An Thới Đông
baixui	bại xụi
batduoc	bắt được
ancabolo	ăn cá bỏ lờ
bochoa	bốc hoả
bangay	ba ngay
baria-vungtau	Bà Rịa-Vũng Tàu
bieuhieu	biểu hiệu
boibep	bồi bếp
bathutoc	ba thứ tóc
baohieu	báo hiệu
bavai	bà vãi
anlen	ăn lên
andan	An Dân
baotay	bạo tay
boduoc	bổ dược
baothau	bao thầu
binhthu	binh thư
benganvungchi	bền gan vững chí
aobanh-to	áo bành-tô
aikhien	ai khiến
ando	An Đô
banhmatgiang	bánh mặt giăng
bongnhoang	bóng nhoáng
banchan	bận chân
botoai	bò toài
bannhuvaidan	bắn như vãi đạn
antonoilon	ăn to nói lớn
au	âu
aobia	áo bìa
amtin	âm tín
bongbong	bong bong
ba-ta	ba-ta
auvang	âu vàng
anca	ăn cá
bogion	bộ giỡn
